place_original	place_harmonized
Aachen	Aachen
Aadami (Kastre vald)	Aadami (Kastre vald)
Aadmal [Hiiumaa]	Aadmal [Hiiumaa]
Aakre	Aakre
Aalborg	Aalborg
Aarau	Aarau
Aaspere	Aaspere
Aaviku	Aaviku
Aaviku küla	Aaviku küla
Aberdeen	Aberdeen
Abingdon	Abingdon
Abington	Abington
Abja	Abja
Abjas	Abja
Абя	Abja
Abja-Paluoja	Abja-Paluoja
Abja-Paluoja (Viljandimaa)	Abja-Paluoja
Abja-Paluoja [Viljandimaa]	Abja-Paluoja
Mulgimaa, [Abja-Paluoja]	Abja-Paluoja
[Abja-Paluoja], Mulgimaa	Abja-Paluoja
Aboæ	Aboæ
Abruka	Abruka
Absecon?	Absecon
Adavere	Adavere
Adavere [Jõgevamaa]	Adavere
Adelaide	Adelaide
Adelaide?	Adelaide
Adra küla (Harku vald)	Adra küla (Harku vald)
Aegna	Aegna
Aegviidu	Aegviidu
Aegviidus	Aegviidu
Aegwiidus	Aegviidu
Aegviidu [Harjumaa]	Aegviidu
Aegviidus [Harjumaa]	Aegviidu
Aespa	Aespa
Agen	Agen
Ahrensburg	Ahrensburg
Ahtme	Ahtme
Aichach	Aichach
Aizpute	Aizpute
Al-Qāhirah	Al-Qāhirah
Alatskivi	Alatskivi
Alatskivi (Tartumaa)	Alatskivi
Alatskivi [Tartumaa]	Alatskivi
Alatskivil	Alatskivi
Alavere	Alavere
Albany	Albany
Alberta	Alberta
Albolote (Granada)	Albolote (Granada)
Albu	Albu
Albu [Järvamaa]	Albu
Albu küla	Albu
Aldershot [etc.]	Aldershot
Alexandria (Virginia)	Alexandria (Virginia)
Alexandria, Virginia	Alexandria (Virginia)
Algeria	Algeria
Allika	Allika
Allikjärve küla	Allikjärve küla
Alliku (Harjumaa	Alliku (Harjumaa)
Alliku (Harjumaa)	Alliku (Harjumaa)
Alliku küla	Alliku (Harjumaa)
Алма-Ата	Almaty
Алматы	Almaty
Alnarp	Alnarp
Alphen aan den Rijn	Alphen aan den Rijn
Altdorf	Altdorf
Alten Stettin	Alten Stettin
Altenburg	Altenburg
Altenstadt	Altenstadt
Altenstadt/Oberbayern	Altenstadt/Oberbayern
Altenstadt/Schongau	Altenstadt/Oberbayern
Altnurga [Jõgevamaa]	Altnurga [Jõgevamaa]
Altona	Altona
Altsaare	Altsaare
Alu	Alu (Raplamaa)
Alu (Raplamaa)	Alu (Raplamaa)
Alu [Raplamaa]	Alu (Raplamaa)
Aluksne	Aluksne
Marienburg	Aluksne
Alunda	Alunda
Alutaguse	Alutaguse
Amberg	Amberg
Ambla	Ambla
Ambla (Järvamaa)	Ambla
Ameerika Ühendriigid	Ameerika Ühendriigid
Ameerika Ühendriikides	Ameerika Ühendriigid
U.S.	Ameerika Ühendriigid
U.S.A.	Ameerika Ühendriigid
USA	Ameerika Ühendriigid
USA?	Ameerika Ühendriigid
In the United States of America	Ameerika Ühendriigid
United States	Ameerika Ühendriigid
United States?	Ameerika Ühendriigid
United States of America	Ameerika Ühendriigid
Ames (Iowa)	Ames (Iowa)
Amherst (Mass.)	Amherst (Mass.)
Amherst (Massachusetts)	Amherst (Mass.)
Amherst, Mass.	Amherst (Mass.)
Amritapuri, Kerala, India	Amritapuri, Kerala, India
Amsterdam	Amsterdam
Amsterdam [etc.]	Amsterdam
Amsterdam?	Amsterdam
Andover	Andover
Andover (Conn.)	Andover (Conn.)
Aneby	Aneby
Anija	Anija
Ankara	Ankara
Ann Arbor	Ann Arbor
Ann Arbor (Mich.)	Ann Arbor
Ann Arbor (USA)	Ann Arbor
Anna	Anna
Anna (Järvamaa)	Anna (Järvamaa)
Annandale-on-Hudson, N.Y.	Annandale-on-Hudson, N.Y.
Annikoru	Annikoru
Annikoru (Tartumaa)	Annikoru
Ansbach	Ansbach
Ansbach?	Ansbach
Anseküla	Anseküla
Anseküla [Saaremaa]	Anseküla
Antequera	Antequera
Antsla	Antsla
Antsla [Võrumaa]	Antsla
Antverpiae	Antwerpen
Antwerpen	Antwerpen
Anvers	Antwerpen
Ao küla (Lääne-Virumaa)	Ao küla (Lääne-Virumaa)
Apeldoorn	Apeldoorn
Araabia Ühendemiraadid	Araabia Ühendemiraadid
Aravete	Aravete
Aravetel	Aravete
Ardu	Ardu
Ardu [Harjumaa]	Ardu [Harjumaa]
Are	Are
Arendal	Arendal
Архангельск	Arkhangel’sk
Arkna	Arkna
Arkna küla (Lääne-Virumaa)	Arkna küla (Lääne-Virumaa)
Arles	Arles
Arlington	Arlington
Arlöv	Arlöv
Arnsberg	Arnsberg
Arnstadt	Arnstadt
Aruküla	Aruküla
Aruküla (Harjumaa)	Aruküla
Aruküla [Harjumaa]	Aruküla
Arula	Arula
Aruvalla	Aruvalla küla
Aruvalla (Harjumaa)	Aruvalla küla
Aruvalla küla	Aruvalla küla
Aruvalla küla (Rae vald)	Aruvalla küla
Arvidsjaur [Rootsi]	Arvidsjaur [Rootsi]
Arvika	Arvika
Aschaffenburg	Aschaffenburg
Aseri	Aseri
Kõrtsialuse	Aseri
Aseri [Ida-Virumaa	Aseri [Ida-Virumaa
Aseri [Ida-Virumaa]	Aseri [Ida-Virumaa
Rannu	Aseri [Ida-Virumaa
Ашгабат	Ashgabat
Ашхабад	Ashgabat
Ащгабат	Ashgabat
Ashland (Oreg.)	Ashland (Oreg.)
Askim (Rootsi)	Askim (Rootsi)
Aspach	Aspach
Assamalla	Assamalla
Assamalla (Lääne-Virumaa)	Assamalla
Assikvere	Assikvere
Aste	Aste
Aste [Saare maakond]	Aste
Астрахань	Astrakhan
Atglen (Pa.)	Atglen (Pa.)
Ateena	Athens
Athens	Athens
Athènes	Athens
Αθήνα	Athens
Atlanta	Atlanta
Atlanta, Ga	Atlanta
Aude (Harjumaa)	Aude (Harjumaa)
Aude, Harjumaa	Aude (Harjumaa)
Audru	Audru
Audrus	Audru
Audru [Pärnumaa]	Audru [Pärnumaa]
Audru alevik	Audru [Pärnumaa]
Põldeotsa	Audru [Pärnumaa]
Augsburg	Augsburg
Augsburg?	Augsburg
Augsburgis	Augsburg
Augsburg - Hochfeld	Augsburg
Augsburg [Saksamaa]	Augsburg
Augsburg-Hochfeld	Augsburg
Augsburg-Hochfeld [Saksamaa]	Augsburg
Augspurg	Augsburg
Aurich	Aurich
Austin ... etc.	Austin
Austin, TX	Austin
Austraalia	Austraalia
Austraalia?	Austraalia
Australia	Austraalia
Australia?	Austraalia
Austria	Austria
Avanduse-Hirla	Avanduse-Hirla
Avesta	Avesta
Avignon	Avignon
Avinurme	Avinurme
Avinurme (Ida-Virumaa)	Avinurme (Ida-Virumaa)
Avinurme [Ida-Virumaa]	Avinurme (Ida-Virumaa)
Ida-Virumaa	Avinurme (Ida-Virumaa)
Ору (Ida-Virumaa)	Avinurme (Ida-Virumaa)
Avispea	Avispea
Avon	Avon
Backhofenberg	Backhofenberg
Düben	Bad Düben
Bad Hersfeld	Bad Hersfeld
Bad Homburg	Bad Homburg vor der Höhe
Bad Langensalza	Bad Langensalza
Langensalza	Bad Langensalza
Bad Orb [Saksamaa]	Bad Orb [Saksamaa]
Bad Salzuflen	Bad Salzuflen
Bad Soden-Salmünster	Bad Soden-Salmünster
Badacsonytomaj	Badacsonytomaj
Badacsonytördemic	Badacsonytördemic
Baden-Baden	Baden-Baden
Baku	Baku
Bakı	Baku
Баку	Baku
Бакы	Baku
Балабаново	Balabanovo
Балашиха	Balashikha
Baltimore	Baltimore
Baltimore (Maryland)	Baltimore
Baltimore (Md.)	Baltimore
Baltimore (U.S.A.)	Baltimore
Bamberg	Bamberg
Bamberg [Germany]	Bamberg
Bannockburn (Ill.) [USA]	Bannockburn (Ill.) [USA]
Banská Bystrica	Banská Bystrica
Barby	Barby
Barcelona	Barcelona
Bargteheide	Bargteheide
Barmen	Barmen
Барнаул	Barnaul
Barth	Barth
Basel	Basel
Basel?	Basel
Basilea	Basel
Basingstoke	Basingstoke
Basingstoke (Hampshire)	Basingstoke
Bath	Bath
Bathurst	Bathurst
Bayreuth	Bayreuth
Bayside	Bayside
Beacon, N.Y	Beacon, N.Y
Beau Bassin	Beau Bassin-Rose Hill
Beauport	Beauport
Beaverton	Beaverton
Beijing	Beijing
Peking	Beijing
Belfast	Belfast
Belgia	Belgia
Belgium	Belgia
Beograd	Belgrade
Белград	Belgrade
Београд	Belgrade
Belgrave (Victoria)	Belgrave (Victoria)
Belgrave (Victoria) [Austraalia	Belgrave (Victoria)
Beltsville	Beltsville
Beltsville (Maryland U. S. A)	Beltsville
Beltsville (Maryland)	Beltsville
Beltsville (Md.)	Beltsville
Бендеры	Bender
Bennington	Bennington
Bennington, Vt	Bennington
Bergen	Bergen
Paradis	Bergen
Bergisch Gladbach	Bergisch Gladbach
Berkeley	Berkeley
Berkeley [etc.]	Berkeley
Berliin	Berlin
Berliin?	Berlin
Berliinis	Berlin
Berlin	Berlin
Berlin [etc.]	Berlin
Berlin?	Berlin
Berlin, Germany	Berlin
Berolini	Berlin
Берлин	Berlin
Берлин?	Berlin
Berlin-Lichterfelde	Berlin-Lichterfelde
Bermagui South	Bermagui South
Bern	Bern
Bern [etc.]	Bern
Berne	Bern
Beromünster	Beromünster
Berth	Berth
Bethesda (Md.)	Bethesda (Md.)
Beverly Hills	Beverly Hills
Bialystok	Białystok
Bicske	Bicske
Bielefeld	Bielefeld
Bielefeld/Brackwede	Bielefeld
Bietigheim-Bissingen	Bietigheim-Bissingen
Bietlot	Bietlot
Bihać	Bihać
Bingen	Bingen
Binghamton (NY)	Binghamton (NY)
Bingley	Bingley
Bingley [etc.]	Bingley
Birmingham	Birmingham
Фрунзе	Bishkek
Bleicherode am Harz	Bleicherode am Harz
Blieskastel	Blieskastel
Bloomington	Bloomington
Bloomington?	Bloomington
Bloomington (Ind.)	Bloomington (Ind.)
Bloomington (Ind.)?	Bloomington (Ind.)
Bloomington, Ind	Bloomington (Ind.)
Boca Raton	Boca Raton
Boca Raton [etc.]	Boca Raton
Bochum	Bochum
Bochum [etc]	Bochum
Boda kyrkby	Boda kyrkby
Bodmin	Bodmin
Bologna	Bologna
Bad Godesberg	Bonn
Bonn	Bonn
Bonn?	Bonn
Bonn-Bad Godesberg	Bonn
Godesberg	Bonn
Bordeaux	Bordeaux
Bordesholm	Bordesholm
Borgholm	Borgholm
Bornholm	Bornholm
Borrby	Borrby
Borrby, Vormsi	Borrby
Boras	Borås
Borås	Borås
Boston	Boston
Boston [etc.]	Boston
Boston (Mass.)	Boston
Bougival [France]	Bougival [France]
Boulder	Boulder
Boulder [etc.]	Boulder
Boulder (Colorado)	Boulder
Bournemouth	Bournemouth
Bovenden	Bovenden bei Göttingen
Bovenden bei Göttingen	Bovenden bei Göttingen
Bowling Green (Ohio)	Bowling Green (Ohio)
Boxholm	Boxholm
Brabrand	Brabrand
Brackenheim	Brackenheim
Bradford	Bradford
Brampton	Brampton
Brampton (Ontario)	Brampton [Kanada]
Brampton [Kanada]	Brampton [Kanada]
Bramsche	Bramsche
Brandenburg	Brandenburg
Bratislava	Bratislava
Pressburg	Bratislava
Братислава	Bratislava
Braunschweig	Braunschweig
Breda	Breda
Breda [Madalmaad]	Breda [Madalmaad]
Bregenz	Bregenz
Bremen	Bremen
Bremen, Deutschland	Bremen
Bremerhaven	Bremerhaven
Brest	Brest
Bridgeton	Bridgeton
Brighton	Brighton
Brisbane	Brisbane
Bristol	Bristol
Brno	Brno
Bromma	Bromma
Bromma (Rootsi)	Bromma
Brookfield	Brookfield
Brooklyn	Brooklyn
Brooklyn (N.Y.)	Brooklyn
Brooklyn, NY	Brooklyn
Bruklina	Brooklyn
Brookvale	Brookvale
Brumunddal	Brumunddal
Braunsberg	Brunsbergae
Brunsbergae	Brunsbergae
Brussel	Brussels
Brussels	Brussels
Bruxellae	Brussels
Bruxelles	Brussels
Bruxelles [etc.]	Brussels
Brxelles	Brussels
Brüssel	Brussels
Брюссель	Brussels
Брянск	Bryansk
Brühl	Brühl
Bucharest	Bucharest
Bucuresti	Bucharest
Bucureşti	Bucharest
București	Bucharest
Bukarest	Bucharest
Бухарест	Bucharest
Budapest	Budapest
Buenos Aires	Buenos Aires
Buffalo	Buffalo
Buffalo, USA	Buffalo
Bulgaaria	Bulgaaria
Burgess Hill	Burgess Hill
Burlington	Burlington
Burnaby (Kanada)	Burnaby (Kanada)
Buxheim (Allgäu)	Buxheim (Allgäu)
Bydgoszcz	Bydgoszcz
Böhlau	Böhlau
Bühl/Baden	Bühl/Baden
Büsum	Büsum
Caen	Caen
Cahors	Cahors
Kairo	Cairo
القاهرة	Cairo
Calgary	Calgary
Calgary?	Calgary
California	California
Calw	Calw
Cambridge (Mass.)	Cambridge (Mass.)
Cambridge, MA	Cambridge (Mass.)
Cambridge	Cambridge [etc.
Cambridge [etc.]	Cambridge [etc.
Cambridge [etc.	Cambridge [etc.
Cambridgeshire	Cambridgeshire
Canada	Canada
Canada?	Canada
Jõekääru (Kanada)	Canada
Kanada	Canada
Kanada?	Canada
Kotkajärve(Kanada)	Canada
Seedrioru (Kanada)	Canada
Seedriorus [Kanada]	Canada
Canberra	Canberra
Canberra?	Canberra
Canmore (Alberta)	Canmore (Alberta)
Cape Town	Cape Town
Caracas	Caracas
Cardiff	Cardiff
Cardiff [etc.]	Cardiff
Cardiff [United Kingdom]	Cardiff
Cardiff [et al.]	Cardiff
Cardiff [etc]	Cardiff
Cardigan	Cardigan
Carmichael, California	Carmichael, California
Cary (NC)	Cary (NC)
Casani	Casani
Catania	Catania
Catena di Villorba	Catena di Villorba
Catthorpe Manor (Suurbritannia)	Catthorpe Manor (Suurbritannia)
Chadstone (Victoria)	Chadstone (Victoria)
Chalfont St. Peter	Chalfont St. Peter
Cham	Cham
Cham [etc.]	Cham
Champaign [etc.]	Champaign
Charleston	Charleston
Charleston [USA]	Charleston
Шупашкар	Cheboksary
Чехов	Chekhov
Челябинск	Chelyabinsk
Черновцы	Chernivtsi
Черноголовка	Chernogolovka
Черноголовка (Моск. обл.)	Chernogolovka
Insterburg	Chernyakhovsk
Chester Springs	Chester Springs
Chester Springs, PA	Chester Springs
Chicago	Chicago
Chicago (Ill.)	Chicago
Chichester, UK	Chichester, UK
Bancroft	Chililabombwe
China	China
Chişinău	Chisinau
Кишинев	Chisinau
Кишинеу	Chisinau
Кишинэу	Chisinau
Christchurch	Christchurch
Chur	Chur
Cincinnati	Cincinnati
Cincinnati [etc.]	Cincinnati
Cincinnati [USA]	Cincinnati
Clagenfurth	Clagenfurth
Klagenfurt/Celovec	Clagenfurth
Clermont-Ferrand	Clermont-Ferrand
Cleveland	Cleveland
Cobourg (Ont.)	Cobourg (Ont.)
Coburg	Coburg
Cochrane (Wis.)	Cochrane (Wis.)
College Park (Md.)	College Park (Md.)
College Station (Tex.)	College Station (Tex.)
Collingwood	Collingwood
Colorado Springs	Colorado Springs
Columbia	Columbia
Columbia, Connecticut	Columbia, Connecticut
Columbia, in the USA	Columbia, in the USA
Columbus (Ohio)	Columbus (Ohio)
Commack	Commack
Condé-sur-Noireau	Condé-sur-Noireau
Connecticut	Connecticut
Copenhagen	Copenhagen
Copenhague	Copenhagen
Kiøbenhavn	Copenhagen
Kjobenhavn	Copenhagen
Kjøbenhavn	Copenhagen
Kobenhavn	Copenhagen
Kopenhaagen	Copenhagen
Kopenhagen	Copenhagen
Köpenhamn	Copenhagen
Københaven	Copenhagen
København	Copenhagen
Køobenhavn	Copenhagen
Cork, Ireland	Cork, Ireland
Cornelius (N.C.)	Cornelius (N.C.)
Costa Mesa [USA]	Costa Mesa [USA]
Coventry	Coventry
Croydon	Croydon
Crozon	Crozon
Culemborg	Culemborg
Cuneo	Cuneo
Curitiba	Curitiba
Czech Republic	Czech Republic
Cölln	Cölln
Cöln	Cöln
Cesis	Cēsis
Cēsis	Cēsis
Венден	Cēsis
Dallas (Tex.)	Dallas (Tex.)
Danderyd	Danderyd
Dantisci	Dantisci
Darlinghurst	Darlinghurst
Darlington	Darlington
Darmstadt	Darmstadt
Darmstadt-Eberstadt	Darmstadt
Darmstadt-Eberstadt [Saksamaa]	Darmstadt
Darpatâ	Darpatâ
Dârpatâ	Darpatâ
Daugavpils	Daugavpils
Двинск	Daugavpils
Taiwan	Dawan
DeKalb	DeKalb
DeKalb (Ill.)	DeKalb
Debrecen	Debrecen
Delhi	Delhi
New Delhi	Delhi
Denmark	Denmark
Denver	Denver
Detmold	Detmold
Detroit	Detroit
Dettelbach	Dettelbach
Deutschland [i. e. Hamburg]	Deutschland [i. e. Hamburg]
Deventer	Deventer
Dijon	Dijon
Dillenburg	Dillenburg
Dillenburg (Saksamaa)	Dillenburg [Saksamaa]
Dillenburg [Saksamaa]	Dillenburg [Saksamaa]
Dinglingen	Dinglingen
Djupadal	Djupadal
Djursholm	Djursholm
Днiпропетровськ	Dnipro
Днепропетровск	Dnipro
Екатеринослав	Dnipro
Dobbs Ferry (New York)	Dobbs Ferry (New York)
Долгопрудный	Dolgoprudnyy
Don Mills	Don Mills
Don Mills (Kanada)	Don Mills
Don Mills, Ont	Don Mills
Донецк	Donetsk
Dorchester	Dorchester
Dordrecht	Dordrecht
Dordrecht [etc.]	Dordrecht
Dorpati	Dorpati
Dortmund	Dortmund
Downwood	Downwood
Dresden	Dresden
Dresden?	Dresden
Dresdenis-Fr	Dresden
Drezden	Dresden
Дрезден	Dresden
Duaci	Duaci
Dubai	Dubai
Dubais	Dubai
Baile Átha Cliath	Dublin
Dublin	Dublin
Дубровицы (Моск. обл.)	Dubrovitsy
Дубровицы (Московская обл.)	Dubrovitsy
Duisburg	Duisburg
Duisburg?	Duisburg
Duluth	Duluth
Durham (N.C.)	Durham (N.C.)
Душаньбе	Dushanbe
Душанбе	Dushanbe
Дзержинск	Dzerzhinsk
Döbeln	Döbeln
Döhren	Döhren
Düsseldorf	Düsseldorf
Düsseldorf?	Düsseldorf
Neudamm	Dębno
EU	EU
EL-s	EU
Euroopa	EU
Euroopas	EU
Euroopa  Liidus	EU
Euroopa Liidus	EU
Euroopa Liit	EU
Euroopa liidus	EU
In the European Union	EU
EU:ssa	EU:ssa
East Roseville	East Roseville
Eastleigh	Eastleigh
Ebenhausen	Ebenhausen
Ebenhausen bei München	Ebenhausen bei München
Eberstadt	Eberstadt
Ebsdorfergrund	Ebsdorfergrund
Edgewood	Edgewood
Edinburgh	Edinburgh
Edise (Ida-Virumaa)	Edise (Ida-Virumaa)
Edmonton	Edmonton
Edmonton (Alberta)	Edmonton
Eerde	Eerde
Eerikvere	Eerikvere
Eesti	Eesti
Eesti?	Eesti
Eestis	Eesti
Estland	Eesti
Estland?	Eesti
Estonia	Eesti
Эстония	Eesti
Eesti Vabariik	Eesti Vabariik
Eesti [p.o. Kose (Harjumaa)]	Eesti [p.o. Kose (Harjumaa)]
Egeln	Egeln
Egilsstöðum	Egilsstaðir
Ehstland	Ehstland
Eidapere	Eidapere
Eidapere (Raplamaa)	Eidapere
Einbi	Einbi
Eisenach	Eisenach
Eisleben	Eisleben Lutherstadt
Eisma	Eisma
Eistvere küla	Eistvere küla
Elbing	Elbing
Ellamaa [Harjumaa	Ellamaa [Harjumaa
Elora	Elora
Elva	Elva
Elvas	Elva
Эльва	Elva
Wedemark-Elze	Elze
Wedemark-Elze [Deutschland]	Elze
Emmaste	Emmaste
Emmaste (Hiiumaa)	Emmaste (Hiiumaa)
Emmaste [Hiiumaa]	Emmaste (Hiiumaa)
Emmaste osavald	Emmaste (Hiiumaa)
Emmern	Emmern
Emsdetten (Westf.)	Emsdetten (Westf.)
Emu Plains (New South Wales)	Emu Plains (New South Wales)
Enge	Enge
Enges	Enges
England	England
Englewood	Englewood
Englewood Cliffs (N.J.)	Englewood Cliffs (N.J.)
Enskede	Enskede
Enumclaw (Wash.)	Enumclaw (Wash.)
Erala	Erala
Erastvere	Erastvere
Erfordiae	Erfurt
Erfurt	Erfurt
Erlangen	Erlangen
Erlangen [Deutschland]	Erlangen
Eru	Eru
Esbjerg	Esbjerg
Esbjerg [Denmark]	Esbjerg
Eschenburg	Eschenburg
Eschenburg (Saksamaa)	Eschenburg
Eschenburg [Saksamaa]	Eschenburg
Eskilstuna	Eskilstuna
Eskilstuna [Sweden]	Eskilstuna
Eskiltuna	Eskilstuna
Esku	Esku
Esku [Jõgevamaa]	Esku
Esku küla	Esku
Eslingena	Eslingena
Esbo	Espoo
Espoo	Espoo
Essen	Essen
Esslingen	Esslingen
Eugene (Or.)	Eugene (Or.)
Eugene (Ore.)	Eugene (Or.)
Eutin	Eutin
Evanston	Evanston
Evanston (Ill.)	Evanston
Evanston [USA]	Evanston
Falköping	Falköping
Faloppio	Faloppio
Falun	Falun
Farmington, Conn	Farmington, Conn
Farnham	Farnham
Fayetteville, NY	Fayetteville, NY
Fergus Falls	Fergus Falls
Ferrara	Ferrara
Finland	Finland
Finnland	Finland
Parka (Soome)	Finland
Suomi	Finland
Финляндия	Finland
Flensburg	Flensburg
Firenze	Florence
Footscray [etc.]	Footscray
Forbushof	Forbushof
Forssa	Forssa
Fort Mitchell	Fort Mitchell
Fort Wayne (USA)	Fort Wayne (USA)
Franeker	Franeker
Frankenthal	Frankenthal
Frankfurt (Oder)	Frankfurt (Oder)
Frankfurt an der Oder	Frankfurt (Oder)
Frakfurt am Main	Frankfurt am Main
Franckfurt am Main	Frankfurt am Main
Franckfurth	Frankfurt am Main
Frankfurt	Frankfurt am Main
Frankfurt Am Main	Frankfurt am Main
Frankfurt Main	Frankfurt am Main
Frankfurt a. M	Frankfurt am Main
Frankfurt a.M	Frankfurt am Main
Frankfurt a.M. [etc.]	Frankfurt am Main
Frankfurt am Main	Frankfurt am Main
Frankfurt am Main  [etc.]	Frankfurt am Main
Frankfurt am Main [etc.]	Frankfurt am Main
Frankfurt am Main ... [etc.]	Frankfurt am Main
Frankfurt/Main	Frankfurt am Main
Франкфурт на Майне	Frankfurt am Main
Frascati	Frascati
Fredericia	Fredericia [Taani]
Fredericia [Taani]	Fredericia [Taani]
Frederick	Frederick
Frederiksberg	Frederiksberg
Frederikshavn	Frederikshavn
Frederikshavn?	Frederikshavn
Fredrikshavn	Frederikshavn
Freiburg	Freiburg
Freiburg [etc.]	Freiburg
Freiburg i. B	Freiburg
Freiburg im Breisgau	Freiburg
Freising	Freising
Fresno, Kalifornia	Fresno, Kalifornia
Freudenstadt	Freudenstadt
Fribourg	Fribourg
Berlin-Friedenau	Friedenau
Friedewald-Dresden	Friedewald-Dresden
Friedrichshafen [Saksamaa]	Friedrichshafen [Saksamaa]
Fujimi	Fujimi
Fulham	Fulham
Færna	Færna
Fürstenfeldbruck	Fürstenfeldbruck
Gainesville	Gainesville
Gainesville, Fla.	Gainesville
Gamlingay	Gamlingay
Garden City (N.Y.)	Garden City (N.Y.)
Gargždai	Gargždai
Garmisch-Partenkirchen	Garmisch-Partenkirchen
Gatschina	Gatchina
Гатчина	Gatchina
Gateshead	Gateshead
Gatineau	Gatineau
Dantzig	Gdańsk
Danzig	Gdańsk
Gdańsk	Gdańsk
Gdov	Gdov
Oudova	Gdov
Gdynia	Gdynia
Geislingen	Geislingen
Geislingen?	Geislingen
Geislingenis	Geislingen
Geislingen (Saksamaa)	Geislingen
Geislingen (St.)	Geislingen
Geislingen (Steige	Geislingen
Geislingen (Steige)	Geislingen
Geislingen /St.	Geislingen
Geislingen :[s.n.]	Geislingen
Geislingen-Steige	Geislingen
Geislingen-Steige [Saksamaa]	Geislingen
Geislingen/ St.	Geislingen
Geislingen/St	Geislingen
Geislingen/Steige	Geislingen
Geislingen/Stge	Geislingen
Genova	Genoa
Gand	Gent
Gent	Gent
Ghent	Gent
Geneva	Genève
Geneve	Genève
Genf	Genève
Genève	Genève
Genéve	Genève
Женева	Genève
Penang	George Town
Geretsried	Geretsried
Geretsriedis	Geretsried
Germantown	Germantown
Deutschland	Germany
Deutschland?	Germany
Germany	Germany
In Germany	Germany
Märzfeldis [Saksamaa	Germany
Vacija	Germany
Germersheim	Germersheim
Gerpinnes	Gerpinnes
Giessen [Deutschland]	Giessen [Deutschland]
Giessen	Gießen
Gimo	Gimo
Gjøvik	Gjøvik
Glasgow	Glasgow
Glebe (N.S.W.)	Glebe (N.S.W.)
Glendale, Isle of Skye [United Kingdom]	Glendale, Isle of Skye [United Kingdom]
Glesborg	Glesborg
Glinde	Glinde
Gliwice	Gliwice
Glücksburg /Ostsee	Glücksburg /Ostsee
Glückstadt	Glückstadt
Gnadau	Gnadau
Goettingae	Goettingae
Goolwa	Goolwa
Gotha	Gotha
Gotha?	Gotha
Granada	Granada
Granville	Granville
Gratz	Graz
Graz	Graz
Great Britain	Great Britain
Suurbritannia	Great Britain
United Kingdom	Great Britain
Greenacres, Australia	Greenacres, Australia
Greenwich (Conn.)	Greenwich (Conn.)
Greifswald	Greifswald
Greiz	Greiz
Greve, Taani	Greve, Taani
Grodzisk Mazowiecki	Grodzisk Mazowiecki
Groitzsch	Groitzsch
Groningen	Groningen
Groningen [Netherlands]	Groningen
Грозный	Groznyy
Berlin-Grunewald	Grunewald
Gräfenhainichen	Gräfenhainichen
Guangzhou	Guangzhou
Gebweiler	Guebwiller
Guildford	Guildford
Guildford [etc.]	Guildford
Guilford (Conn.)	Guilford, Connecticut
Guilford, Connecticut	Guilford, Connecticut
Gumbinnen	Gusev
Gyoma	Gyomaendrőd
Gyomaendrőd	Gyomaendrőd
Gyula	Gyula
Győr	Győr
Gefle	Gävle
Gävle	Gävle
Göppingen	Göppingen
Görlitz	Görlitz
Gothenburg	Göteborg
Göteborg	Göteborg
Göteborg?	Göteborg
Götegorg	Göteborg
Goettingen	Göttingen
Göttingen	Göttingen
Göttingen [etc.]	Göttingen
Göttingen?	Göttingen
In Göttingen	Göttingen
Gørløse	Gørløse
Güstrow	Güstrow
Gütersloh	Gütersloh
Haabneeme	Haabneeme
Haabneeme (Harju maakond)	Haabneeme
Haabneeme (Harjumaa)	Haabneeme
Haabneeme [Harjumaa	Haabneeme
Haabneeme [Harjumaa]	Haabneeme
Haanja	Haanja
Haanjas	Haanja
Haapsalu	Haapsalu
Haapsalu?	Haapsalu
Haapsalus	Haapsalu
Гапсaль	Haapsalu
Гапсаль	Haapsalu
Hapsal	Haapsalu
Hapsal?	Haapsalu
Hapsalu	Haapsalu
Хаапсалу	Haapsalu
Haarlem	Haarlem
Haaslava	Haaslava
Haavasalu	Haavasalu
Habaja	Habaja
Habaja (Harjumaa)	Habaja
Habaja [Harjumaa]	Habaja
Haeska [Läänemaa]	Haeska [Läänemaa]
Hagen	Hagen
Hageri	Hageri
Hageri [Raplamaa]	Hageri
Hagudi [Raplamaa]	Hagudi [Raplamaa]
Halifax	Halifax
Halifax [United Kingdom]	Halifax [United Kingdom]
Halinga [Pärnumaa]	Halinga [Pärnumaa]
Halis Saxonum	Halis Saxonum
Haljala	Haljala
Haljala (Lääne-Virumaa)	Haljala
Haljala [Lääne-Virumaa]	Haljala
Halle	Halle (Saale)
Halle?	Halle (Saale)
Halle (Saale)	Halle (Saale)
Halle a. S	Halle (Saale)
Halle im Magdeburgischen	Halle im Magdeburgischen
Halliste	Halliste (Viljandimaa)
Halliste (Viljandimaa)	Halliste (Viljandimaa)
Hallistes [Viljandimaa]	Halliste (Viljandimaa)
Halmstad	Halmstad
Halmstad [Rootsi]	Halmstad
Hamburg	Hamburg
Hamburg [etc.]	Hamburg
Hamburgis	Hamburg
Hamburis	Hamburg
Hamburi	Hamburg
Hamburg-Hamm	Hamburg
Hamburg-Rahlstedt	Hamburg-Rahlstedt
Hameln	Hameln
Hamilton	Hamilton
Hamilton [Kanada]	Hamilton
Hamilton, Ontario	Hamilton
Hamina	Hamina
Hampstead	Hampstead
Hampton	Hampton
Hanau	Hanau am Main
Handimiku (Võrumaa)	Handimiku (Võrumaa)
Hanila [Läänemaa]	Hanila [Läänemaa]
Lääne-Nigula	Hanila [Läänemaa]
Palivere (Läänemaa)	Hanila [Läänemaa]
Änniste [Läänemaa]	Hanila [Läänemaa]
Hanko	Hanko
Hanko [Soome]	Hanko
Hannover	Hannover
Hannoverae	Hannover
Hannover-Döhren	Hannover-Döhren
Hannover-Dören	Hannover-Döhren
Hanover-Döhren	Hannover-Döhren
Hann. Münden	Hannoversch Münden
Hara küla	Hara küla
Харбин	Harbin
Harderovici	Harderovici
Hargla	Hargla
Harju	Harju
Jäneda [Harjumaa]	Harju
Luidja [Harjumaa]	Harju
Mõnuka (Harjumaa)	Harju
Viitna [Harjumaa]	Harju
Harju (Hiiumaa)	Harju (Hiiumaa)
Harju-Risti	Harju-Risti
Harku vald	Harku vald
Harku (Harjumaa)	Harkujärve
Harkujärve	Harkujärve
Harkujärve küla	Harkujärve
Harmondsworth	Harmondsworth
Harrisburg (Pa.)	Harrisburg (Pa.)
Harrow	Harrow on the Hill
Habana	Havana
La Habana	Havana
XXX	Haßfurt
Hechingen	Hechingen
Heide	Heide
Heidelberg	Heidelberg
Heidelberg [etc.]	Heidelberg
Гейдельберг	Heidelberg
Heidenheim	Heidenheim an der Brenz
Heilbronn	Heilbronn
In Heilbronn	Heilbronn
Heiligenstadt	Heiligenstadt
Heimtali	Heimtali
Heimtali (Viljandimaa)	Heimtali
Heinaste	Heinaste
Heinävesi	Heinävesi
Båstad	Heiås
Hellenurmes	Hellenurme
Helme	Helme
Helme (Valgamaa)	Helme
Helme [Valgamaa]	Helme
Helmes [Valgamaa]	Helme
Helmstadii	Helmstadii
Helmstedt	Helmstedt
Helsingborg	Helsingborg
Helsingør	Helsingborg
Hälsingborg	Helsingborg
Hälsingborg [Rootsi]	Helsingborg
Helsingfors	Helsinki
Helsingi	Helsinki
Helsingis	Helsinki
Helsingissä	Helsinki
Helsingki	Helsinki
Helsingsfors	Helsinki
Helsinki	Helsinki
Helsinki?	Helsinki
Helsinki-Helsingfors	Helsinki
Helskinki	Helsinki
Гельсингфорс	Helsinki
Хельсинки	Helsinki
Hemel Hempstead	Hemel Hempstead
Hengelo	Hengelo
Henley Beach	Henley Beach
Henley Beach (Australia)	Henley Beach
Herjava	Herjava
Herne	Herne
Hernösand	Hernösand
Herrljunga	Herrljunga
Herrljunga [Rootsi]	Herrljunga
Herrnhut	Herrnhut
Hexham	Hexham
Hiiumaa	Hiiumaa
Hilana	Hilana
Hilana (Võrumaa)	Hilana
Hilana küla	Hilana
Hilden	Hilden
Hildesheim	Hildesheim
Hildesheim [etc.]	Hildesheim
Hildesheim [etc., Deutschland]	Hildesheim
Hillerød	Hillerød
Hillsborough	Hillsborough
Hillsborough (New Jersey)	Hillsborough
Hillsborough (USA)	Hillsborough
Hillsdale, NY	Hillsdale, NY
Hindås	Hindås
España	Hispaania
Hispaania	Hispaania
Hispaanias	Hispaania
No	Ho
Hoboken (N.J.)	Hoboken (N.J.)
Hoboken, NJ	Hoboken (N.J.)
Hoboken, New Jersey	Hoboken (N.J.)
Holdres	Holdre
Holland	Holland
Nederland	Holland
Netherlands	Holland
Hollfeld	Hollfeld
Hollywood	Hollywood
Holstebro	Holstebro
Holstre	Holstre
Holstres	Holstre
Holte	Holte
Holte (Danmark)	Holte (Danmark)
Holtland	Holtland
Holvandi (Põlvamaa)	Holvandi (Põlvamaa)
Holyoke	Holyoke
Гомель	Homyel'
Hong Kong	Hong Kong
Hongkong	Hong Kong
Honkong	Hong Kong
Гонконг	Hong Kong
Horn	Hoorn
Жодино	Horad Zhodzina
Horma	Horma
Horma (Võrumaa)	Horma
Horn bei Hamburg	Horn bei Hamburg
Horneburg	Horneburg
Houston	Houston
Houston (USA)	Houston (USA)
Houston [USA]	Houston (USA)
Гродно	Hrodna
Huddinge	Huddinge
Huddinge (Rootsi)	Huddinge
Hudiksvall	Hudiksvall
Hulja (Lääne-Virumaa)	Hulja (Lääne-Virumaa)
Hullo	Hullo
Hullo (Vormsi)	Hullo
[Hullo], Vormsi	Hullo
Hummuli	Hummuli
Hummulis	Hummuli
Hummuli (Valgamaa)	Hummuli
Hummuli [Valgamaa]	Hummuli
Hummulis [Valgamaa]	Hummuli
Hundisilma [talu, Eru küla]	Hundisilma [talu, Eru küla]
Huntsville	Huntsville
Hurda [Võrumaa]	Hurda [Võrumaa]
Hurmi (Põlvamaa)	Hurmi (Põlvamaa)
Husum	Husum
Huuksi	Huuksi
Hvidovre	Hvidovre
Hyderabad	Hyderabad
Hyvinkää	Hyvinge
Hämeenlinna	Hämeenlinna
Tavastehus	Hämeenlinna
Hässleholm	Hässleholm
Gutmannsbach	Häädemeeste
Häädemeeste	Häädemeeste
Häädemeeste?	Häädemeeste
Häädemeeste [Pärnumaa]	Häädemeeste
Häätaru	Häätaru
Höganäs	Höganäs
Högbacka	Högbacka
Höör	Höör
Hørsholm	Hørsholm
Hørsholm [Denmark]	Hørsholm
Hüüru	Hüüru
Iasi	Iaşi
Ичня	Ichnia
Ihamaru	Ihamaru
Ihasalu	Ihasalu
Iisaku	Iisaku
Iisaku?	Iisaku
Iisaku (Ida-Virumaa)	Iisaku
Iisaku [Ida-Virumaa]	Iisaku
Ikla	Ikla
Ikla (Pärnumaa)	Ikla
Illuka	Illuka
Illuka [Ida-Virumaa]	Illuka
Illuka küla	Illuka
Иллука	Illuka
Ilmandu	Ilmandu
Ilmandu (Harjumaa)	Ilmandu
Ilmandu küla (Harjumaa)	Ilmandu
Ilmatsalu	Ilmatsalu
Ilmatsalus	Ilmatsalu
Tüki	Ilmatsalu
Tüki (Tartumaa)	Ilmatsalu
Ilmenau	Ilmenau
Ilumäe	Ilumäe
Imavere	Imavere
Imaveres	Imavere
Imavere (Järvamaa)	Imavere
Imavere [Järvamaa	Imavere
Imavere [Järvamaa]	Imavere
India	India
Indias	India
Индия	India
Indianapolis	Indianapolis
Inglismaa	Inglismaa
Ingliste küla	Ingliste küla
Ingolstadt	Ingolstadt
Innsbruck	Innsbruck
Innsbruck-Mühlau	Innsbruck
Inowrocław	Inowrocław
Iowa City, IA	Iowa City, IA
Irboska	Irboska
Иркутск	Irkutsk
Irvine	Irvine
Irvine (Calif.)	Irvine
Irvine (California)	Irvine
Istambul	Istanbul
Istanbul	Istanbul
İstanbul	Istanbul
Itaalia	Itaalia
Itaalias	Itaalia
Italy	Itaalia
Ithaca (N.Y.)	Ithaca (N.Y.)
Itzehoe	Itzehoe
Iurievi	Iurievi
Иваново	Ivanovo
Ivaski (Viljandimaa)	Ivaski (Viljandimaa)
Ижевск	Izhevsk
Ижкар	Izhevsk
Jaagupi	Jaagupi
Jaapan	Jaapan
Japan	Jaapan
Jackson	Jackson
Jackson (New Jersey)	Jackson (New Jersey)
Janakkala	Janakkala
Jaén	Jaén
Jefferson, North Carolina	Jefferson, North Carolina
Hirschberg	Jelenia Góra
Jelgava	Jelgava
Jelgavā	Jelgava
Jelgawa	Jelgava
Miitavi	Jelgava
Mitau	Jelgava
Елгава	Jelgava
Митава	Jelgava
In Jena	Jena
Jena	Jena
Jenae	Jenae
Jerusalem	Jerusalem
Jeruusalemm	Jerusalem
Иерусалим	Jerusalem
Joaveski küla	Joaveski küla
Joensuu	Joensuu
Johannesburg	Johannesburg
Jokioinen	Jokioinen
Jonsered	Jonsered
Joutsa	Joutsa
Juminda	Juminda
Juminda [Harjumaa]	Juminda
Juula	Juula
Juuru	Juuru
Juuru (Raplamaa)	Juuru
Juuru [Raplamaa]	Juuru
Juva	Juva
Jyväskyla	Jyväskyla
Jyväskylässä	Jyväskyla
Jyväskylä	Jyväskylä
Jászberény	Jászberény
Jädivere	Jädivere
Jädivere (Raplamaa)	Jädivere
Jädivere küla	Jädivere
Естонія [Jädivere küla]	Jädivere
Jälevere	Jälevere
Jälgimäe	Jälgimäe
Jälgimäe (Harjumaa)	Jälgimäe
Jämejala	Jämejala
Jämejala (Viljandimaa)	Jämejala
Jäneda	Jäneda
Jäneda (Lääne-Virumaa)	Jäneda
Jäneda [Järvamaa]	Jäneda [Järvamaa]
Järfalla	Järfalla
Järfälla	Järfalla
Järiste küla	Järiste küla
Järtsaare	Järtsaare
Järva-Jaani	Järva-Jaani
Järva-Jaanis	Järva-Jaani
Järva-Madise [Järvamaa	Järva-Madise [Järvamaa
Järvakandi	Järvakandi
Järvaküla	Järvaküla (Tartumaa)
Järvaküla (Tartumaa	Järvaküla (Tartumaa)
Järvaküla (Tartumaa)	Järvaküla (Tartumaa)
Järva maakond	Järvamaa
Järvamaa	Järvamaa
Kume [Järvamaa]	Järvamaa
Järveküla	Järveküla
Järvere (Võrumaa)	Järvere (Võrumaa)
Järvselja	Järvselja
Jõe	Jõe
Jõelähtme	Jõelähtme
Jõelähtme (Harjumaa)	Jõelähtme
Jõelähtme [Harjumaa	Jõelähtme
Jõelähtme küla	Jõelähtme
Jõeääre	Jõeääre
Jõeääre (Pärnumaa)	Jõeääre (Pärnumaa)
Jõeääre (Raplamaa)	Jõeääre (Raplamaa)
Jôgeva (Eesti)	Jõgeva
Jõgeva	Jõgeva
Jõgeva?	Jõgeva
Jõgeva (Eesti)	Jõgeva
Jõgeval	Jõgeva
Йыгева	Jõgeva
Jõgeva vald, Lõpe-Reimani	Jõgeva vald, Lõpe-Reimani
Lõpe [Jõgevamaa]	Jõgeva vald, Lõpe-Reimani
Jõgevamaa	Jõgevamaa
Ranna [Jõgevamaa]	Jõgevamaa
Jõgewal	Jõgewal
Jõgisoo	Jõgisoo
Jõhvi	Jõhvi
Jõhvis	Jõhvi
Jõhvi (Ida-Virumaa)	Jõhvi
[Jõhvi], Ida-Virumaa	Jõhvi
Йыхви	Jõhvi
Jõiste	Jõiste
Jõulumäe	Jõulumäe
Leina (Pärnumaa)	Jõulumäe
Jõune?	Jõune (Jõgevamaa)
Jõune (Jõgevamaa)	Jõune (Jõgevamaa)
Jõõpre	Jõõpre
Jönköping	Jönköping
Jüchen	Jüchen
Jüri	Jüri
Jüri (Harjumaa)	Jüri
Jüri [Harjumaa]	Jüri
Jürjev	Jürjev
Jakobstadt	Jēkabpils
Kaagna	Kaagna
Kaagna küla	Kaagna
Kaagvere	Kaagvere
Kaagvere (Põlvamaa)	Kaagvere
Kaali	Kaali
Kaansoo (Raplamaa)	Kaansoo (Raplamaa)
Kaarepere	Kaarepere
Kaarepere (Jõgevamaa)	Kaarepere (Jõgevamaa)
Kaarina	Kaarina
Kaarli	Kaarli
Kaarma (Saare maakond)	Kaarma [Saare maakond]
Kaarma [Saare maakond]	Kaarma [Saare maakond]
Kaarma [Saaremaa]	Kaarma [Saare maakond]
Kaaruka küla [Järvamaa]	Kaaruka küla [Järvamaa]
Kaasiku küla	Kaasiku küla
Kaasikvälja	Kaasikvälja
Kabala	Kabala
Kabila	Kabila
Kablaküla	Kablaküla
Kabli	Kabli [Pärnumaa
Kabli [Pärnumaa	Kabli [Pärnumaa
Kadrina	Kadrina
Kadrina (Lääne-Virumaa)	Kadrina [Lääne-Virumaa]
Kadrina [Lääne-Virumaa]	Kadrina [Lääne-Virumaa]
Kadrina vald	Kadrina [Lääne-Virumaa]
Kadrina-Loobu	Kadrina-Loobu
Kaevere	Kaevere
Kaevere (Läänemaa)	Kaevere küla (Läänemaa)
Kaevere küla (Läänemaa)	Kaevere küla (Läänemaa)
Kahtla	Kahtla
Kahula [Ida-Virumaa]	Kahula [Ida-Virumaa]
Kaigutsi	Kaigutsi
Kaigutsi (Hiiumaa)	Kaigutsi
Kaiserslautern	Kaiserslautern
Kaisma	Kaisma
Kaitsemõisa	Kaitsemõisa
Kaiu	Kaiu
Kakumetsa	Kakumetsa
Kalana	Kalana
Kalana (Hiiumaa)	Kalana [Hiiumaa]
Kalana [Hiiumaa]	Kalana [Hiiumaa]
Kalana küla	Kalana [Hiiumaa]
Kalesi	Kalesi
Kalesi (Harjumaa)	Kalesi
Kalinal	Kalinal
Kaliningrad	Kaliningrad
Królewiec	Kaliningrad
Königsberg	Kaliningrad
Königsberg in Pr	Kaliningrad
Калининград	Kaliningrad
Kallaste	Kallaste
Kallavere	Kallavere
Kallaveres	Kallavere
Kallavere (Harjumaa)	Kallavere
Rootsi-Kallavere	Kallavere
Kallemäe	Kallemäe
Kalmar	Kalmar
Kalmar [Sweden]	Kalmar
Kalme (Tartumaa)	Kalme (Tartumaa)
Kaluga	Kaluga
Калуга	Kaluga
Kamari	Kamari [Jõgeva maakond]
Kamari [Jõgeva maakond]	Kamari [Jõgeva maakond]
Kamari [Jõgevamaa]	Kamari [Jõgeva maakond]
Kambja	Kambja
Kambjas	Kambja
Kambja (Tartumaa)	Kambja
Kambja [Tartumaa	Kambja
Kambja [Tartumaa]	Kambja
Kammeri	Kammeri
Kanaküla	Kanaküla
Kanavere	Kanavere
Kanavere küla	Kanavere
Kandla	Kandla
Kanepi	Kanepi
Kanepis	Kanepi
Kanepi (Põlvamaa)	Kanepi
Kanepi [Põlvamaa	Kanepi
Kanepi [Põlvamaa]	Kanepi
Канепи	Kanepi
Kangasala	Kangasala
Kangasala [Soome]	Kangasala [Soome]
Järveküla (Harjumaa)	Kangru alevik
Kangru	Kangru alevik
Kangru alevik	Kangru alevik
Kangsti	Kangsti
Kannuküla (Viljandimaa)	Kannuküla (Viljandimaa)
Kapus	Kapu
Karala (Saaremaa)	Karala (Saaremaa)
Karhula	Karhula
Karilatsi	Karilatsi
Karilatsi (Põlvamaa)	Karilatsi
Karilatsi küla	Karilatsi
Karilatsis [Põlvamaa]	Karilatsi
Karinu	Karinu
Karitsa ([Raplamaa)	Karitsa ([Raplamaa)
Karja	Karja
Karjamaa [Tallinn]	Karjamaa [Tallinn]
Karksi	Karksi
Karksi (Viljandimaa)	Karksi (Viljandimaa)
Karksi [Viljandimaa]	Karksi (Viljandimaa)
Karksi-Nuia	Karksi-Nuia
Nuias	Karksi-Nuia
Karkuse	Karkuse
Karkuse (Lääne-Virumaa)	Karkuse
Karla	Karla (Harjumaa)
Karla (Harjumaa)	Karla (Harjumaa)
Kärla	Karla (Harjumaa)
Karlshamn	Karlshamn
Karlskrona	Karlskrona
Karlsruhe	Karlsruhe
Карлсруэ	Karlsruhe
Karlstad	Karlstad
Karula	Karula
Karula (Valgamaa)	Karula (Valgamaa)
Karula (Võrumaa)	Karula (Võrumaa)
Karuse	Karuse
Kasispea	Kasispea
Esiküla	Kassari
Kassari	Kassari
Кассари	Kassari
Kassari [Hiiumaa]	Kassari
Cassel	Kassel
Kassel	Kassel
Kassema	Kassema
Kasteheinal [Tartu]	Kassema
Kassinurme [Jõgevamaa]	Kassinurme [Jõgevamaa]
Kastre	Kastre
Kata küla	Kata küla (Kose vald)
Kata küla (Kose vald)	Kata küla (Kose vald)
Katrineholm	Katrineholm
Kauda (Tartumaa)	Kauda (Tartumaa)
Kauhava	Kauhava
Kauksi	Kauksi
Kaukvere (Lääne-Virumaa)	Kaukvere (Lääne-Virumaa)
Kauen	Kaunas
Kaunas	Kaunas
Kowno	Kaunas
Каунас	Kaunas
Kauniainen	Kauniainen
Kaustinen	Kaustinen
Кайнар	Kaynar
Казан	Kazan
Казань	Kazan
Keava	Keava
Kecskemét	Kecskemét
Kehra	Kehra
Kehras	Kehra
Kehra (Harjumaa)	Kehra
Kehra [Harjumaa]	Kehra
Kehtna	Kehtna
Kehtna (Harjumaa)	Kehtna
Kehtna [Raplamaa]	Kehtna
Keibu	Keibu
Keibu (Harjumaa)	Keibu
Keibu küla	Keibu
Keila	Keila
Keila?	Keila
Keilas	Keila
Кегель	Keila
Keila linn	Keila
Кейла	Keila
Kelvingi	Kelvingi (Harjumaa)
Kelvingi (Harjumaa)	Kelvingi (Harjumaa)
Кемерово	Kemerovo
Kemi	Kemi
Kempele	Kempele
Kempen/Allgäu	Kempten (Allgäu)
Kempten	Kempten (Allgäu)
Kempten/Allgäu	Kempten (Allgäu)
Kempton [USA]	Kempton [USA]
Kent (England)	Kent (England)
Kent Town	Kent Town
Kent Town [Australia]	Kent Town
Kerava	Kerava
Kernu	Kernu
Keuru	Keuruu
Keuruu	Keuruu
Хабаровск	Khabarovsk
Charkow	Kharkiv
Harkiv	Kharkiv
Харьков	Kharkiv
Kherson	Kherson
Херсон	Kherson
Kibworth Beauchamp	Kibworth Beauchamp
Kiduspe	Kiduspe
Kiduspe [Hiiumaa]	Kiduspe [Hiiumaa]
Kiel	Kiel
Kielce	Kielce
Kihelkonna	Kihelkonna
Kihnu	Kihnu
Kihnu [jne.]	Kihnu
Kihnu (Pärnu maakond)	Kihnu
Kiideva	Kiideva
Kiidjärve	Kiidjärve
Kiidjärve (Põlvamaa)	Kiidjärve
Kiidjärve [Põlvamaa]	Kiidjärve
Kiikla küla	Kiikla küla
Kiili	Kiili
Kiisa	Kiisa
Kiisa [Harjumaa]	Kiisa
Kiiu	Kiiu
Kildu [Viljandimaa]	Kildu [Viljandimaa]
Kilingi-Nõmme	Kilingi-Nõmme
Kilingi-Nõmme?	Kilingi-Nõmme
Kilingi-Nõmmes	Kilingi-Nõmme
Килинги-Немме	Kilingi-Nõmme
Кургунд-Немме	Kilingi-Nõmme
Куркунд-Немме	Kilingi-Nõmme
Kilingi-Nõmme (Pärnumaa)	Kilingi-Nõmme
Kilingi[-Nõmme]	Kilingi-Nõmme
Kurkund-Nõmme	Kilingi-Nõmme
Saarde	Kilingi-Nõmme
[Kilingi-]Nõmme	Kilingi-Nõmme
[Kilingi]-Nõmme	Kilingi-Nõmme
Килинги-Нымме	Kilingi-Nõmme
Kiloni[i]	Kiloni[i]
Kiltsi	Kiltsi
Kiltsi [Lääne-Virumaa]	Kiltsi [Lääne-Virumaa]
Kimberley	Kimberley
Kemiö	Kimito
King's Lynn	King's Lynn
Kingisepa	Kingisepa
Kirchhain	Kirchhain
Kirchzarten-Zarten	Kirchzarten-Zarten
Kirderanna	Kirderanna
Kirikuküla	Kirikuküla
Kirivere	Kirivere
Kirmsi (Põlvamaa)	Kirmsi (Põlvamaa)
Kirna	Kirna
Вятка	Kirov
Киров	Kirov
Kista	Kista
Kista?	Kista
Kista (Sweden)	Kista
Kivi-Vigala	Kivi-Vigala
Kivi-Vigala [Raplamaa]	Kivi-Vigala [Raplamaa]
Kivijärve	Kivijärve
Alutaguse (Ida-Virumaa)	Kiviõli
Kiviõli	Kiviõli
Кивиыли	Kiviõli
Kiwimäe-Nõmme-Seewald [Tallinn]	Kiwimäe-Nõmme-Seewald [Tallinn]
Klagenfurt	Klagenfurt am Wörthersee
Klaipeda	Klaipėda
Memel	Klaipėda
Kleve	Kleve
Клин	Klin
Klintehamn	Klintehamn
Klooga	Klooga
Kloogaranna	Kloogaranna
Kloogaranna (Harjumaa)	Kloogaranna
Kloostri	Kloostri
Kodasema küla	Kodasema küla
Kodavere	Kodavere
Kodavere (Jõgevamaa)	Kodavere (Jõgevamaa)
Kodijärve	Kodijärve
Kodila - Metsküla	Kodila - Metsküla
Kodila [Raplamaa]	Kodila [Raplamaa]
Koela (Läänemaa)	Koela (Läänemaa)
Koeru	Koeru
Koeru (Järvamaa)	Koeru
Koeru [Järvamaa]	Koeru
Koerus [Järvamaa]	Koeru
Koguva	Koguva
Когува	Koguva
Koguva küla	Koguva
Kohala	Kohala
Kohatu	Kohatu
Kohila	Kohila (Raplamaa)
Kohila (Raplamaa)	Kohila (Raplamaa)
Kohtla vald	Kohila (Raplamaa)
Kohta-Järve	Kohtla- Järve
Kohtla- Järve	Kohtla- Järve
Kohtla‐Järve	Kohtla- Järve
Kohtla-Järve	Kohtla-Järve
Mõisamaa küla	Kohtla-Järve
Кохтла-Ярве	Kohtla-Järve
Kohtla	Kohtla-Nõmme
Kohtla-Nõmme	Kohtla-Nõmme
Kohtla-Nõmme [Ida-Virumaa]	Kohtla-Nõmme
Koidu	Koidu
Koidu (Harjumaa)	Koidu (Harjumaa)
Koigi	Koigi
Koigi (Järvamaa)	Koigi
Prandi [Järvamaa]	Koigi
Koigu	Koigu
Koigu (Võrumaa)	Koigu
Koigu küla [Valgamaa]	Koigu
Koikküla (Valgamaa)	Koikküla (Valgamaa)
Koima	Koima
Kõima	Koima
Koiola	Koiola
Koitjärve	Koitjärve
Kokkola	Kokkola
Kolepi	Kolepi
Kolga	Kolga
Kolga (Harjumaa	Kolga
Kolga alevik	Kolga
Kolga (Harjumaa)	Kolga (Harjumaa)
Kolga [Harjumaa]	Kolga (Harjumaa)
Kolga-Jaani	Kolga-Jaani
Kolga-Jaanis	Kolga-Jaani
Kolgaküla	Kolgaküla
Kolgakülas	Kolgaküla
Calcutta	Kolkata
Kolkja (Tartumaa)	Kolkja (Tartumaa)
Колкья - Тарту	Kolkja (Tartumaa)
Koloreino (Võrumaa)	Koloreino (Võrumaa)
Saaremaal	Koloreino (Võrumaa)
Колывань	Kolyvan’
Келломяки	Komarovo
Konguta	Konguta
Konguta (Tartumaa)	Konguta (Tartumaa)
Konju	Konju
Konstanz	Konstanz
Koogi (Tartu vald)	Koogi (Tartu vald)
Kookla	Kookla
Kooli	Kooli
Koolina	Koolina
Koonga	Koonga
Kooraste	Kooraste
Koper	Koper
Koppelmaa (Saue vald)	Koppelmaa (Saue vald)
Kose	Kose
Kose (Võrumaa)	Kose (Võrumaa)
Kose (Harjumaa)	Kose-Uuemõisa
Kose-Uuemõisa	Kose-Uuemõisa
Kose-Uuemõisas	Kose-Uuemõisa
Kosel	Kosel
Kostivere	Kostivere
Кострома	Kostroma
Kotinuka	Kotinuka
Kotka	Kotka
Kotka-Järve (Kanada)	Kotka-Järve (Kanada)
Kotkajärve	Kotkajärve
Kottgeisering	Kottgeisering
Куру	Kourou
Košice	Košice
Cracoviae	Kraków
Krakau	Kraków
Krakow	Kraków
Kraków	Kraków
Красноярск	Krasnoyarsk
Krefeld	Krefeld
Krei küla (Kose vald)	Krei küla (Kose vald)
Krems	Krems an der Donau
Kristianstad	Kristianstad
Kristinehamn	Kristinehamn
Kroonlinn	Kronstadt
Кронштадт	Kronstadt
Krootuse	Krootuse
Krundiküla	Krundiküla
Krylbo	Krylbo
Kubija	Kubija
Võru-Kubijal	Kubija
Kuhjavere	Kuhjavere
Kuhjavere [Viljandimaa]	Kuhjavere
Kuigatsi	Kuigatsi
Kuijõe	Kuijõe
Kuijõe küla	Kuijõe küla
Kuivastu	Kuivastu
Kuivastu küla	Kuivastu
Kukruse	Kukruse
Kuku	Kuku
Kuldre (Võrumaa)	Kuldre (Võrumaa)
Goldingen	Kuldīga
Kuldīga	Kuldīga
Гольдинген	Kuldīga
Kulla (Viljandimaa)	Kulla (Viljandimaa)
Kullamaa	Kullamaa
Kullamaa [(Läänemaa)	Kullamaa
Kullamaa [Läänemaa]	Kullamaa
Kulmbach	Kulmbach
Kulna [Harjumaa]	Kulna [Harjumaa]
Kumla	Kumla
Kumma [Raplamaa]	Kumma [Raplamaa]
Kunda	Kunda
Kundas	Kunda
Кюндя	Kunda
Кунгур	Kungur
Kungälv	Kungälv
Kuningvere	Kuningvere
Kuopio	Kuopio
Kuremaa	Kuremaa
Kuremaal	Kuremaa
Kuremäe	Kuremäe
Kуремяэ	Kuremäe
Куремяэ	Kuremäe
Kurepalu	Kurepalu
Kurepalus	Kurepalu
Kingisepp	Kuressaare
Kingissepa	Kuressaare
Kingissepp	Kuressaare
Arensburg	Kuressaare
Arensburg?	Kuressaare
Kuresaare	Kuressaare
Kuresaares	Kuressaare
Kuresaare  [s.o. Kuressaare]	Kuressaare
Kuresaare [i.e. Kuressaare	Kuressaare
Kuresaare [i.e. Kuressaare]	Kuressaare
Kuresaare [s.o. Kuressaare	Kuressaare
Kuresaare [s.o. Kuressaare]	Kuressaare
Kuresaares [i.e. Kuressaare]	Kuressaare
Kuresaares [s.o. Kuressaare	Kuressaare
Kuresaares [s.o. Kuressaare]	Kuressaare
Kuressaare	Kuressaare
Kuressaare?	Kuressaare
Kuressaares	Kuressaare
Kurresare linnas	Kuressaare
Kurresare	Kuressaare
Kurresares	Kuressaare
Аренсбург	Kuressaare
Кингисепп	Kuressaare
Кингиссепп	Kuressaare
Kuressaari	Kuressaare
Курессааре	Kuressaare
Kuressare	Kuressare
Kurgja	Kurgja
Kurgja-Linnutaja	Kurgja-Linnutaja
Kuri	Kuri
Kurista	Kurista
Kurtna	Kurtna
Куртна	Kurtna
Kuru	Kuru
Kuuda	Kuuda
Kuusalu	Kuusalu
Kuusalus	Kuusalu
Kuusalu (Harjumaa)	Kuusalu
Põhja küla	Kuusalu
Kuusalu vald	Kuusalu vald
Kuusiku	Kuusiku
Kuutsi	Kuutsi
Куйбышев	Kuybyshev
Кузьминки	Kuz’minki
Кяхта	Kyakhta
Kiev	Kyiv
Kiievis	Kyiv
Kиïв	Kyiv
В Киев [etc.]	Kyiv
Кiув	Kyiv
Kiiev	Kyiv
Kyiv	Kyiv
Кiев	Kyiv
Киiв	Kyiv
Киiев	Kyiv
Киев	Kyiv
Київ	Kyiv
Kyoto	Kyoto
Käesla	Käesla
Kähri (Põlvamaa)	Kähri (Põlvamaa)
Käina	Käina
Käina (Hiiumaa)	Käina
Kämara	Kämara
Kärde	Kärde
Kärdla	Kärdla
Kärdla?	Kärdla
Кярдла	Kärdla
Kärevere	Kärevere
Kärkna	Kärkna
Kärkölä	Kärkölä
Kärstna	Kärstna
Käru	Käru
Käsmu	Käsmu
Käsmu [Lääne-Virumaa]	Käsmu
Käsukonna (Järvamaa)	Käsukonna (Järvamaa)
Kääpa	Kääpa
Kääpa (Võrumaa)	Kääpa (Võrumaa)
Kääpa (Jõgevamaa)	Kääpa küla
Kääpa küla	Kääpa küla
Saare (Jõgevamaa)	Kääpa küla
Saare [Jõgevamaa]	Kääpa küla
Käärdi	Käärdi
Eesti [Käärdi]	Käärdi (Tartumaa)
Käärdi (Tartumaa)	Käärdi (Tartumaa)
Käärdi [Tartumaa]	Käärdi (Tartumaa)
Kääriku	Kääriku
Кяэрику	Kääriku
Kållered	Kållered
Kõinastu	Kõinastu
Kõlleste	Kõlleste
Kõmmaste (Harjumaa)	Kõmmaste (Harjumaa)
Kõo	Kõo
Kõpu	Kõpu
Kõrgessaare	Kõrgessaare (Hiiumaa)
Kõrgessaare (Hiiumaa)	Kõrgessaare (Hiiumaa)
Kõrgessaare [Hiiumaa	Kõrgessaare (Hiiumaa)
Kõrveküla	Kõrveküla
Kõrveküla [Tartumaa]	Kõrveküla [Tartumaa]
Tila	Kõrveküla [Tartumaa]
Kõrvemaa	Kõrvemaa
Kõrvemetsa [Ida-Virumaa]	Kõrvemetsa [Ida-Virumaa]
Colonia	Köln
Köln	Köln
Köln [etc.]	Köln
Köln-Rodenkirchen	Köln
Königsberg	Königsberg
Königsbronn	Königsbronn
Königsbrück	Königsbrück
Königstein im Taunus	Königstein im Taunus
Königstein in Taunus	Königstein im Taunus
Köningstein im Taunus	Königstein im Taunus
Köningsberg	Köningsberg
Cöthen	Köthen
Cöthen (Anhalt)	Köthen
Köthen	Köthen
Külitse	Külitse
Kündja	Kündja
Kündja (Võrumaa)	Kündja
Küttejõu	Küttejõu
Glatz	Kłodzko
La Laguna	La Laguna
La Neuville sur Essonne	La Neuville sur Essonne
Lavergne	La Vergne
Laadi	Laadi
Laadi (Pärnumaa)	Laadi (Pärnumaa)
Laadi [Pärnumaa]	Laadi (Pärnumaa)
Laadjala	Laadjala
Laadjala (Saaremaa)	Laadjala (Saaremaa)
Laadjalas [Saaremaa]	Laadjala (Saaremaa)
Meedlas	Laadjala (Saaremaa)
Alliku	Laagri
Laagri	Laagri
Laagri (Harjumaa)	Laagri
Laagri [Harjumaa]	Laagri
Laane	Laane
Laatre	Laatre
Laatre (Valgamaa)	Laatre
Laekvere	Laekvere
Laeva	Laeva
Lagedi	Lagedi
Lagedi (Harjumaa)	Lagedi
Logos	Lagos
Laguja	Laguja
Lahavere	Lahavere
Laheküla	Laheküla
Lahemaa	Lahemaa
Lahmuse	Lahmuse
Lahr	Lahr
Lahr-Dinglingen	Lahr
Lahti	Lahti
Laiaküla (Harjumaa)	Laiaküla (Harjumaa)
Äigrumäe	Laiaküla (Harjumaa)
Laimjala	Laimjala
Laimjala (Saaremaa)	Laimjala
Laitse	Laitse
Laitse [Harjumaa]	Laitse
Jõgeva vald, Laiuse	Laiuse
Laiuse	Laiuse
Laiuse (Jõgevamaa)	Laiuse
Laiuse [Jõgevamaa]	Laiuse
Lakemba	Lakemba
Lakewood	Lakewood
Lakewood?	Lakewood
Lakewood (N. J.)	Lakewood
Lakewood (N.J.)	Lakewood
Lakewood (New Jersey)	Lakewood
Lakewood, New Jersey	Lakewood
Lalsi (Viljandimaa)	Lalsi (Viljandimaa)
Rõika	Lalsi (Viljandimaa)
Lancaster (U.K.)	Lancaster (U.K.)
Lancaster, Pa.	Lancaster, Pa.
Landshut	Landshut
Langenthal	Langenthal
Langerma (Pärnumaa)	Langerma (Pärnumaa)
Langley, B.C.	Langley, B.C.
Lanham [etc.]	Lanham
Seabrook	Lanham
Lappeenranta	Lappeenranta
Larsmo	Larsmo
Larvik	Larvik
Lasva	Lasva
Lasva [Võrumaa]	Lasva [Võrumaa]
Latvia	Latvia
Latvija	Latvia
Läti	Latvia
Lätis	Latvia
Isabella	Lauka [Hiiu maakond]
Lauka [Hiiu maakond]	Lauka [Hiiu maakond]
Laulasmaa	Laulasmaa
Laulasmaa (Harjumaa)	Laulasmaa
Laulasmaa [Harjumaa]	Laulasmaa
Laupa	Laupa
Laupa [Järvamaa]	Laupa
Lausanne	Lausanne
Lavassaare	Lavassaare
Lavassaare (Pärnumaa)	Lavassaare (Pärnumaa)
Lavassaare [Pärnumaa]	Lavassaare (Pärnumaa)
Layerthorpe	Layerthorpe
York	Layerthorpe
Le Carteau-Cambresis	Le Carteau-Cambresis
Lecce	Lecce
Leeds	Leeds
Leedu	Leedu
Leedus	Leedu
Leeningraad [!]	Leeningrad [!]
Leeningrad [!]	Leeningrad [!]
Leningraad [!]	Leeningrad [!]
S.-Peterburg	Leeningrad [!]
S.-Petersburg	Leeningrad [!]
Saint-Petersburg	Leeningrad [!]
В Санктпетербурге	Leeningrad [!]
Санктпетербург	Leeningrad [!]
Спб	Leeningrad [!]
Leer	Leer
Leevaku	Leevaku
Leevi	Leevi
Liegnitz	Legnica
Lehetu	Lehetu
Lehmja (Harjumaa)	Lehmja (Harjumaa)
Lehtmetsa (Harju maakond)	Lehtmetsa (Harju maakond)
Lehtse	Lehtse
Lehtses	Lehtse
Lehtse [Järvamaa]	Lehtse [Järvamaa]
Lehu (Pärnumaa)	Lehu (Pärnumaa)
Leicester	Leicester
Leicester (Suurbritannia)	Leicester
Leiden	Leiden
Leiden?	Leiden
Leie	Leie
Cöln [i.e Leipzig]	Leipzig
Cöln [i.e. Leipzig]	Leipzig
Leipzig	Leipzig
Leipzig?	Leipzig
Lipsiae	Leipzig
Narva [p.o. Leipzig]	Leipzig
St. Petersburg [i.e. Leipzig]	Leipzig
[Leipzig]	Leipzig
in Leipzig	Leipzig
Лейпциг	Leipzig
Leisi	Leisi
Leisis	Leisi
Leisi [Saare maakond]	Leisi
Leisu	Leisu
Lelle	Lelle
Lelle (Raplamaa)	Lelle
Lelle [Raplamaa]	Lelle
Lemmatsi	Lemmatsi
Lemmatsi (Tartumaa)	Lemmatsi
Lemmatsi [Tartumaa]	Lemmatsi
Lemmküla	Lemmküla
Lempäälä	Lempäälä
Lenningen	Lenningen
Leppneeme	Leppneeme
Leppneeme (Harjumaa)	Leppneeme
Letchworth	Letchworth Garden City
Leuven	Leuven
Lovanii	Leuven
Leväsjoki	Leväsjoki
Lewiston [etc.]	Lewiston
Lidingö	Lidingö
Libau	Liepāja
Либава	Liepāja
Liettua	Liettua
Lihula	Lihula
Lihulas	Lihula
Lihula (Läänemaa)	Lihula
Lihula [Läänemaa]	Lihula
Libau	Liibavi
Liibavi	Liibavi
Liiküla	Liiküla
Liiküla küla	Liiküla
Liiva (Harjumaa)	Liiva (Harjumaa)
Liivamäe	Liivamäe
Liivi	Liivi
Lilienthal/Bremen	Lilienthal/Bremen
Limburg /Lahn	Limburg /Lahn
Limburg/Lahn	Limburg /Lahn
Linaküla	Linaküla
Linaküla (Kihnu)	Linaküla
Linaküla (Pärnumaa)	Linaküla
Lincoln	Lincoln
Lindanise	Lindanise
Lindesberg	Lindesberg
Lindi	Lindi
Lindome	Lindome
Linköping	Linköping
Linköping [Sweden]	Linköping
Linnuse küla	Linnuse küla
Linte (Põlvamaa)	Linte (Põlvamaa)
Linte [Põlvamaa]	Linte (Põlvamaa)
Linz	Linz
Lippstadt	Lippstadt
Lisboa	Lisbon
Lissabon	Lisbon
Liskeard	Liskeard
Leck	Liège
Ljubljana	Ljubljana
Llangennech	Llangennech
Lobi	Lobi
Logroño	Logroño
Lohkva	Lohkva
Lohkva küla	Lohkva
Lohusalu	Lohusalu
Lohusalu (Harjumaa)	Lohusalu
Lohusuu	Lohusuu
Лохусуу	Lohusuu
Lohvka	Lohvka
Loimaa	Loimaa
Loksa	Loksa
Loksa (Harjumaa)	Loksa
Loksal	Loksa
London	London
London [etc.]	London
London etc	London
London etc.	London
Londonis	London
Londres	London
Лондон	London
London (Ont.)	London (Ont.)
London (Ontario)	London (Ont.)
Lonrai	Lonrai
Loo	Loo (Harjumaa)
Loo (Harjumaa)	Loo (Harjumaa)
Loo ([Harjumaa])	Loo (Harjumaa)
Loo alevik	Loo (Harjumaa)
Loodi	Loodi
Loodna	Loodna
Loona	Loona
Los Altos (Cal.)	Los Altos (Cal.)
Berkeley, Los Angeles	Los Angeles
Los Angeles	Los Angeles
Los Angeles [etc.]	Los Angeles
Los Angeles?	Los Angeles
Los Angeles (Cal.)	Los Angeles
Los Angeles (Calif.)	Los Angeles
Los Angeles, CA	Los Angeles
Lossiküla (Valgamaa)	Lossiküla (Valgamaa)
Loudon (Tenn.)	Loudon (Tenn.)
Louvain	Louvain
Loveland	Loveland
Loveland [USA]	Loveland [USA]
Loveland, Colo	Loveland [USA]
Loviisa	Lovisa
Lovisa	Lovisa
Lublin	Lublin
Lucka	Lucka
Ludwigsburg	Ludwigsburg
Ludza	Ludza
Luhametsa	Luhametsa
Luhametsa küla	Luhametsa
Luige	Luige (Harjumaa)
Luige (Harjumaa)	Luige (Harjumaa)
Luige (Kiili vald)	Luige (Harjumaa)
Luleå	Luleå
Lund	Lund
Lund?	Lund
Lunenburg	Lunenburg
Luoma	Luoma
Lustivere	Lustivere
Lutike	Lutike
Lutike [Valgamaa	Lutike [Valgamaa
Luton	Luton
Luua	Luua
Luua (Jõgevamaa)	Luua
Luunja	Luunja
Luunja [Tartumaa]	Luunja [Tartumaa]
Luksemburg	Luxembourg
Luxembourg	Luxembourg
Luxemburg	Luxembourg
Luzern	Luzern
Lv́ov	Lviv
Львiв	Lviv
Львов	Lviv
Львів	Lviv
Lygnern	Lygnern
Люберцы	Lyubertsy
Lähte	Lähte
Lähte [Tartumaa]	Lähte [Tartumaa]
Lähtse	Lähtse
Läsna (Lääne-Virumaa)	Läsna (Lääne-Virumaa)
Lätkalu	Lätkalu
Lääne-Virumaa	Lääne-Virumaa
Lääneotsa	Lääneotsa
Lõpe	Lõpe
Lübeck	Lübeck
Lüganuse	Lüganuse
Lüllemäe	Lüllemäe
Lüllemäe (Valgamaa)	Lüllemäe (Valgamaa)
Lümanda	Lümanda
Lümborg	Lüneburg
Lüneburg	Lüneburg
Livani	Līvāni
Maardu	Maardu
Uusküla	Maardu
Маарду	Maardu
Maarja	Maarja-Magdaleena
Maarjas	Maarja-Magdaleena
Maarja-Magdaleena	Maarja-Magdaleena
Maasi	Maasi
Maestricht	Maastricht
MacDill Air Force Base (Calif.)	MacDill Air Force Base (Calif.)
Mackay (Queensland)	Mackay (Queensland)
Macomb (Mich.)	Macomb (Mich.)
Madise	Madise (Harjumaa)
Madise (Harjumaa)	Madise (Harjumaa)
Madison	Madison
Madison (Wis.)	Madison
Madison (Wisc.)	Madison
Madison, Wisconsin	Madison
Madona	Madona
Madrid	Madrid
Madriid	Madrid
Магадан	Magadan
Magdeburg	Magdeburg
Могилев	Mahilyow
Mahwah	Mahwah
Maidenhead	Maidenhead
Maidla	Maidla
Maidla [Ida-Virumaa]	Maidla [Ida-Virumaa]
Mainz	Mainz
Majala	Majala
Махачкала	Makhachkala
Malaisia	Malaisia
Malaisias	Malaisia
Малаховка	Malakhovka
Malbork	Malbork
Malden	Malden
Malden (Mass.)	Malden (Mass.)
Malden (Mass.) [etc.]	Malden (Mass.)
Mallavere (Harjumaa)	Mallavere (Harjumaa)
Mallika	Mallika
Malmö	Malmö
Malung	Malung
Heiligenbeil	Mamonovo
Heiligenbeil Ostpr	Mamonovo
Manchester	Manchester
Manchester [USA]	Manchester [USA]
Manila	Manila
Deutschland [Mannheim]	Mannheim
Mannheim	Mannheim
Manniva	Manniva
Manniva küla	Manniva
Mantova	Mantova
Maramaa	Maramaa
Marbach am Neckar [Deutschland]	Marbach am Neckar [Deutschland]
Marburg (Lahn)	Marburg (Lahn)
Marburg a. Lahn	Marburg (Lahn)
Marburg/L	Marburg (Lahn)
Marburg	Marburg an der Lahn
Marburg an der Lahn	Marburg an der Lahn
Marburg/Lahn	Marburg an der Lahn
Marpurg	Marburg an der Lahn
March	March
Maribor	Maribor
Mariehamn	Mariehamn
Marienwerder	Marienwerder
Mariupol	Mariupol
Markaryd	Markaryd
Markham	Markham
Markham, Ontario	Markham, Ontario
Marl	Marl
Marrickville	Marrickville
Marseille	Marseille
Martin	Martin
Martna	Martna
Martna [Läänemaa]	Martna
Masala	Masala
Massachusetts	Massachusetts
Massiaru	Massiaru
Matsalu	Matsalu
Matsalu (Läänemaa)	Matsalu (Läänemaa)
Matsalu küla	Matsalu küla
Mauer bei Wien	Mauer bei Wien
Maywood (Ill.)	Maywood (Ill.)
Meckenheim	Meckenheim
Medford, MA	Medford, MA
Meegaste	Meegaste
Meerkerk (Holland)	Meerkerk (Holland)
Meine	Meine
Meiningen	Meiningen
Meissen	Meissen
Meiuste	Meiuste
A'Beckett St, Victoria	Melbourne
Melbourne	Melbourne
Melbourne?	Melbourne
Melle	Melle
Melle (Hannover)	Melle (Hannover)
Melliste	Melliste
Melliste (Tartumaa)	Melliste
Memmingen	Memmingen
Memphis, Tennessee	Memphis, Tennessee
Menasha, Wis.	Menasha, Wis.
Menlo Park (Calif.)	Menlo Park (Calif.)
Stanford (Cal.)	Menlo Park (Calif.)
Meremäe	Meremäe
Meremõisa	Meremõisa
Merivälja	Merivälja
Merrick (N.Y.)	Merrick (N.Y.)
Merrick, N.Y	Merrick (N.Y.)
Merseburg	Merseburg
Mesnil-sur-l'Estrée	Mesnil-sur-l'Estrée
Metsakasti	Metsakasti
Metsakasti küla [Viimsi]	Metsakasti
Pirita	Metsakasti
Pirita [Tallinn	Metsakasti
Pirita [Tallinn]	Metsakasti
Metsanurme	Metsanurme
Metsanurme [Harjumaa]	Metsanurme
Metsaääre	Metsaääre
Metsaääre (Raplamaa)	Metsaääre (Raplamaa)
Metsaääre küla	Metsaääre küla
Metsla	Metsla
Metsla (Järvamaa)	Metsla (Järvamaa)
Metsla küla	Metsla (Järvamaa)
Metstaga	Metstaga
Metzingen	Metzingen
Metzingen (Württ.)	Metzingen
Mexico	Mexico
México	Mexico
Michelstadt	Michelstadt
Middletown	Middletown
Mihkli	Mihkli
Miiduranna	Miiduranna
Miila	Miila
Mikitamäe	Mikitamäe
Mikitamäe [Põlvamaa]	Mikitamäe [Põlvamaa]
Mikkeli	Mikkeli
St. Mikkelissä	Mikkeli
Milan	Milan
Milan, Italy	Milan
Milano	Milan
Milford (Conn.)	Milford (Conn.)
Milford (Ohio)	Milford (Ohio)
Milton Keynes	Milton Keynes
Minneapolis	Minneapolis
Minneapolis (Minn.)	Minneapolis
Minneapolis, MN	Minneapolis
Minnesota	Minnesota
Minsk	Minsk
Мiнск	Minsk
Минск	Minsk
Мінск	Minsk
Miskolc	Miskolc
Mission	Mission
Mississauga	Mississauga
Mississaugas	Mississauga
Misso	Misso
Misso [Võrumaa]	Misso
Missoula (Mont.)	Missoula (Mont.)
Moakow	Moakow
Moka (Raplamaa)	Moka (Raplamaa)
Monaco	Monaco
Montdidier	Montdidier
Monte Cremasco (Itaalia)	Monte Cremasco (Itaalia)
Montfort-en-Chalosse	Montfort-en-Chalosse
Montmorency	Montmorency
Montreuil-sous-Bois	Montreuil
Montreal	Montréal
Montreal [etc.]	Montréal
Montréal	Montréal
Moonstone (Kanada)	Moonstone (Kanada)
Moorestown	Moorestown
Mooste	Mooste
Mooste (Põlvamaa)	Mooste
Mooste [Põlvamaa]	Mooste
Põlvamaa, Mooste	Mooste
Mora	Mora
Mõra	Mora
Mores (Suecia)	Mores (Suecia)
Morrisville	Morrisville
Moscou	Moscow
Moscova	Moscow
Moscovo	Moscow
Moscow	Moscow
Moscu	Moscow
Moscú	Moscow
Moskau	Moscow
Moskou	Moscow
Moskova	Moscow
Moskva	Moscow
Moskva?	Moscow
Moskvas	Moscow
Moсква	Moscow
Moskvo	Moscow
Moskwa	Moscow
Moskwas	Moscow
Moszkva	Moscow
Mосква	Moscow
Мовква	Moscow
Москва	Moscow
Москва?	Moscow
Москва [и т.д.]	Moscow
Motala	Motala
Можайск	Mozhaysk
Mt. Pleasant (Mich.)	Mt. Pleasant (Mich.)
Liiva	Muhu
Hellamaa	Muhu
Muhu	Muhu
Muhus	Muhu
Tamse [Muhumaa]	Muhu
Muhu-Suurvald	Muhu
Muhumaa	Muhu
Mullavere	Mullavere
Mundaring [Australia]	Mundaring [Australia]
Muenchen	Munich
Munich	Munich
München	Munich
München	Munich
München [etc.]	Munich
München [etc.	Munich
München [etc]	Munich
Мюнхен	Munich
Мюнхен?	Munich
Muraste	Muraste
Muraste (Harjumaa)	Muraste
Muraste [Harjumaa]	Muraste
Muratsi (Saaremaa)	Muratsi (Saaremaa)
Murru	Murru
Murru (Pärnumaa)	Murru
Mustang (Okla)	Mustang (Okla)
Mustja (Võrumaa)	Mustja (Võrumaa)
Mustjala	Mustjala
Mustla	Mustla
Mustla küla	Mustla küla
Mustu	Mustu
Mustvee	Mustvee
Mustvees	Mustvee
Mustvee (Jõgevamaa)	Mustvee
Mustvee [Jõgevamaa]	Mustvee
Муствеэ	Mustvee
Muuga	Muuga
Николаев	Mykolayiv
Málaga	Málaga
Mädapea	Mädapea
Mäeselja [Tartumaa]	Mäeselja [Tartumaa]
Mäetaguse	Mäetaguse
Mäetaguse (Ida-Virumaa)	Mäetaguse
Mäetaguse [Ida-Virumaa]	Mäetaguse
Mägari	Mägari
Mähkli	Mähkli
Mäksa?	Mäksa
Käru [Raplamaa]	Mälivere
Mälivere	Mälivere
Mällikvere	Mällikvere
Mändjala	Mändjala
Mändjala (Saaremaa)	Mändjala (Saaremaa)
Männisalu (Põlvamaa)	Männisalu (Põlvamaa)
Männisalu [Saaremaa]	Männisalu [Saaremaa]
Torgu	Männisalu [Saaremaa]
Mänspe (Hiiumaa)	Mänspe (Hiiumaa)
Märja	Märja
Märja (Tartumaa)	Märja
Märjamaa	Märjamaa
Märzfeld	Märzfeld
Määra	Määra
Mõdriku	Mõdriku (Lääne-Virumaa)
Mõdriku (Lääne-Virumaa)	Mõdriku (Lääne-Virumaa)
Mõedaka	Mõedaka
Mõisaküla	Mõisaküla
Суурупи [Харьюмаа	Mõisaküla
Mõisaküla (Viljandimaa)	Mõisaküla (Viljandimaa)
Mõniste	Mõniste
Mõniste [Võrumaa]	Mõniste
Mölndal	Mölndal
Mölndal (Rootsi)	Mölndal
Mörlenbach	Mörlenbach
Münchenstein [Schweiz]	Münchenstein [Schweiz]
Münster	Münster
Münster [etc.]	Münster
Mārupe	Mārupe
Nabala	Nabala
Nairobi	Nairobi
Naisteväljal	Naisteväljal
Nancy	Nancy
Naruski	Naruski
Narva	Narva
Narva?	Narva
Narvas	Narva
Narwa	Narva
Narwa linnas	Narva
Narwas	Narva
Нарва	Narva
Нарва?	Narva
Narva linn	Narva linn
Narva-Eesti	Narva-Eesti
Narva-Joaoru	Narva-Eesti
Narwa-Joaoru	Narva-Eesti
Нарва (Эстония)	Narva-Eesti
Эстония [i.e. Нарва]	Narva-Eesti
Эстония [Нарва]	Narva-Eesti
Narva Jõesuu	Narva-Jõesuu
Narva-Jõesuu	Narva-Jõesuu
Нарва-Йыэсуу	Narva-Jõesuu
Нарва-Йыэсуу (Усть-Нарва)	Narva-Jõesuu
Усть-Нарва	Narva-Jõesuu
Усть-Нарова	Narva-Jõesuu
Narvik	Narvik
Nashville	Nashville
Nashville (Tennessee)	Nashville
Nassau Bay	Nassau Bay (USA)
Nassau Bay (USA)	Nassau Bay (USA)
Nassau Bay [USA	Nassau Bay (USA)
Nastola	Nastola
Nasva	Nasva
Naumburg	Naumburg
Naumburg a. S	Naumburg
Наумбург	Naumburg
Navesti	Navesti
Neckargemünd	Neckargemünd
Neeme	Neeme
Neeme (Harjumaa)	Neeme
Neeroetern	Neeroetern
Nehatu	Nehatu
Neitsijärve	Neitsijärve
Nela Park	Nela Park
Nelson (B.C.)	Nelson (B.C.)
Neubeuern/Inn	Neubeuern/Inn
Neuhausen-Stuttgart	Neuhausen-Stuttgart
Berlin-Neukölln	Neukölln
Neustadt	Neustadt
Neustadt an der Aisch	Neustadt an der Aisch
Neutral Bay	Neutral Bay
Neuwied	Neuwied
New Brunswick [(N.J.)]	New Brunswick [(N.J.)]
New Haven (Conn.)	New Haven (Conn.)
New Haven, Conn	New Haven (Conn.)
New Jersey	New Jersey
Upper Saddle River (N.J.) [etc.]	New Jersey
New Orleans	New Orleans
New Orleans (La)	New Orleans
Türgi	New Providence
Türgis	New Providence
New Rochelle (N. Y)	New Rochelle (N. Y)
New Rochelle (N.Y.)	New Rochelle (N. Y)
New Rochelle, NY	New Rochelle (N. Y)
New  York	New York City
New York	New York City
New York [etc.]	New York City
New York?	New York City
New York (N.Y.)	New York City
New York (NY)	New York City
New York, N.Y	New York City
New York, NY	New York City
New york	New York City
New-York	New York City
Нью-Йорк	New York City
Newark	Newark
Newberry, SC	Newberry, SC
Newcastle	Newcastle upon Tyne
Newcastle upon Tyne	Newcastle upon Tyne
Newcastle-upon-Tyne	Newcastle upon Tyne
Newport Beach (Calif.)	Newport Beach (Calif.)
Ney	Ney
Niagaara Falls (Kanada)	Niagara Falls (Kanada)
Niagara Falls (Kanada)	Niagara Falls (Kanada)
Niagara Falls (Ont.)	Niagara Falls (Kanada)
Niagara Falls [Kanada]	Niagara Falls (Kanada)
Niedernhausen	Niedernhausen
Niesky	Niesky
Nigula	Nigula
Niitvälja	Niitvälja
Nissi [Harjumaa]	Nissi [Harjumaa]
Gorki	Nizhniy Novgorod
Горький	Nizhniy Novgorod
Феллинн	Nizhniy Novgorod
Noarootsi	Noarootsi
Noarootsi [Läänemaa]	Noarootsi [Läänemaa]
Ноароотси	Noarootsi [Läänemaa]
Norderstedt	Norderstedt
Norman	Norman (Okla.)
Norman (Okl.)	Norman (Okla.)
Norman (Okla.)	Norman (Okla.)
Norra	Norra
Norrköping	Norrköping
Norrköping?	Norrköping
Norrköping (Rootsi)	Norrköping
Norrtälje	Norrtälje
Norsborg	Norsborg
North Adelaide (South Australia)	North Adelaide (South Australia)
North Charleston, SC	North Charleston, SC
North Plympton (Australia)	North Plympton (Australia)
North Ryda (New South Wales)	North Ryda (New South Wales)
North Vancouver	North Vancouver
Northampton	Northampton
Northampton (Mass.)	Northampton (Mass.)
Norwalk	Norwalk
Norwich	Norwich
Norwich [England]	Norwich
Novara	Novara
Novi Ligure	Novi Ligure
Novi Sad	Novi Sad
Новочеркасск	Novocherkassk
Novonikolajevsk	Novonikolajevsk
Novosibirsk	Novosibirsk
Nowo-Nikolajewsk	Novosibirsk
Nowosibirsk	Novosibirsk
Новосибирск	Novosibirsk
Nurmes	Nurme
Nurmsi küla	Nurmsi küla
Nursi (Võrumaa)	Nursi [Võrumaa]
Nursi [Võrumaa]	Nursi [Võrumaa]
Nuustaku	Nuustaku
Nuutre (Viljandimaa)	Nuutre (Viljandimaa)
Nyköping	Nyköping
Neisse	Nysa
Hiiu	Nõmme [Tallinn]
Järve	Nõmme [Tallinn]
Nõmme	Nõmme [Tallinn]
Немме	Nõmme [Tallinn]
Nõmme (Estland)	Nõmme [Tallinn]
Nõmme (Tallinn)	Nõmme [Tallinn]
Nõmme [Tallinn	Nõmme [Tallinn]
Nõmme [Tallinn]	Nõmme [Tallinn]
Nõmme-Rahumäe [Tallinn	Nõmme [Tallinn]
Nõmmel	Nõmme [Tallinn]
Nõmmel [Tallinn	Nõmme [Tallinn]
Nõmmel [Tallinn]	Nõmme [Tallinn]
Tallinn Nõmme	Nõmme [Tallinn]
Нымме	Nõmme [Tallinn]
Nõo	Nõo
Nõos	Nõo
Nõo (Tartumaa)	Nõo
Nõo [Tartumaa]	Nõo
Nõo alevik	Nõo
Nõva	Nõva [Läänemaa]
Nõva [Läänemaa	Nõva [Läänemaa]
Nõva [Läänemaa]	Nõva [Läänemaa]
Nördlingen	Nördlingen
Nüpli küla	Nüpli küla
Nürnberg	Nürnberg
ONL	O'Neill
Oakland	Oakland (California)
Oakland (California)	Oakland (California)
Oberhausen	Oberhausen
Oberpahlen	Oberpahlen
Peltsamā	Oberpahlen
Schloss Oberpahlen	Oberpahlen
Schloss-Oberpahlen	Oberpahlen
Пылтсамаа	Oberpahlen
Obinitsa	Obinitsa
Obinitsa (Võrumaa)	Obinitsa
Obinitsa ... [jne. (Võrumaa)]	Obinitsa
Obinitsa [Võrumaa]	Obinitsa
Obinitsa küla	Obinitsa
Setomaa (Obinitsa)	Obinitsa
Обнинск	Obninsk
Odense	Odense
Odessa	Odessa
Одеса	Odessa
Одесса	Odessa
Одесса?	Odessa
Oessaare (Saaremaa)	Oessaare (Saaremaa)
Offenbach	Offenbach
Ogre	Ogre
Ogre?	Ogre
Огре	Ogre
Ohio	Ohio
Ohtu	Ohtu
Ohtu (Harjumaa)	Ohtu (Harjumaa)
Ohtu [Harjumaa]	Ohtu (Harjumaa)
Ohtu küla	Ohtu (Harjumaa)
Oidrema	Oidrema
Oisu	Oisu [Järvamaa]
Oisu [Järvamaa]	Oisu [Järvamaa]
Õisu	Oisu [Järvamaa]
Old Saybrook	Old Saybrook
Old Tappan (USA, New Jersey)	Old Tappan (USA, New Jersey)
Oldenburg	Oldenburg
Oldenburg in Gr	Oldenburg
Rastede (Oldenburg)	Oldenburg
Olofsborg	Olofsborg
Olsztyn	Olsztyn
Olten	Olten
Olustvere	Olustvere
Omedu (Jõgevamaa)	Omedu (Jõgevamaa)
Omsk	Omsk
Omskis	Omsk
Omski	Omsk
Омск	Omsk
Ontario	Ontario
Oomiste	Oomiste
Oomiste (Tartumaa)	Oomiste
Oonurme	Oonurme
Oonurme [Ida-Virumaa]	Oonurme
Oostkamp	Oostkamp
Opladen	Opladen
Oranienbaum	Oranienbaum
Oranienburg	Oranienburg
Orava	Orava
Оренбург	Orenburg
Orissaare	Orissaare
Orissaare [Saare maakond]	Orissaare [Saare maakond]
Orjaku	Orjaku
Orléans	Orléans
Oropos Attikis [Kreeka]	Oropos Attikis [Kreeka]
Oru	Oru
Ору	Oru
Oru ([Ida-Virumaa)	Oru ([Ida-Virumaa)
Орел	Orël
Osimo	Osimo
Osimo (AN)	Osimo
Oslo	Oslo
Osnabrück	Osnabrück
Ostfildern	Ostfildern
Ostfildern [Deutschland]	Ostfildern
Osula	Osula
Osula (Võrumaa)	Osula [Võrumaa]
Osula [Võrumaa]	Osula [Võrumaa]
Osulas [Võrumaa	Osula [Võrumaa]
Otalampi	Otalampi
Otaniemi	Otaniemi
Otepää	Otepää
Otepää [jne.]	Otepää
Otepääl	Otepää
Otsa	Otsa
Ottawa	Ottawa
Ottawa (Ont.)	Ottawa
Otterndorf (Niederelbe)	Otterndorf (Niederelbe)
Oulu	Oulu
Oxford	Oxford
Oxford [etc.]	Oxford
Ozolnieki	Ozolnieki
Paadremaa	Paadremaa
Paali	Paali
Paderborn	Paderborn
Paderborn [etc.]	Paderborn
Padise	Padise
Padise [Harjumaa]	Padise
Padise küla	Padise
Padstow	Padstow
Paduvere	Paduvere
Paduvere (Jõgeva vald)	Paduvere
Paduvere (Jõgevamaa)	Paduvere
Pagari	Pagari
Pahkla	Pahkla
Pahuvere	Pahuvere
Paide	Paide
Paide?	Paide
Paides	Paide
Вейсенштейн	Paide
Вейссенштейн	Paide
Päide	Paide
Weissenstein	Paide
Пайде	Paide
Paikuse	Paikuse
Paikuse [Pärnumaa	Paikuse
Paikuse [Pärnumaa]	Paikuse
Painküla	Painküla (Jõgevamaa)
Painküla (Jõgevamaa)	Painküla (Jõgevamaa)
Paisley (Šotimaa)	Paisley (Šotimaa)
Paistu	Paistu
Paistu (Viljandimaa)	Paistu
Linnumetsa (Harjumaa)	Pajupea
Pajupea	Pajupea
Vaskjala	Pajupea
Pajusi	Pajusi
Pajusis	Pajusi
Pajusti	Pajusti
Pala	Pala
Pala [Jõgevamaa]	Pala [Jõgevamaa]
Põltsamaa	Pala [Jõgevamaa]
Põltsamaa?	Pala [Jõgevamaa]
Palade	Palade
Palade (Hiiumaa)	Palade
Palamuse	Palamuse
Palamuse (Jõgevamaa)	Palamuse
Palamuse [Jõgevamaa]	Palamuse
Baltiski	Paldiski
Paldiski	Paldiski
Палдиски	Paldiski
Palermo	Palermo
Palivere	Palivere
Palmer Lake, CO	Palmer Lake, CO
Palmse	Palmse
Palmse (Lääne-Virumaa)	Palmse
Palo Alto	Palo Alto (Calif.)
Palo Alto?	Palo Alto (Calif.)
Palo Alto (Calif.)	Palo Alto (Calif.)
Palo Alto, CA	Palo Alto (Calif.)
Palo Alto, CA [etc.]	Palo Alto (Calif.)
Пало-Алто	Palo Alto (Calif.)
Palupera	Palupera
Paluperas	Palupera
Palupõhja (Tartumaa)	Palupõhja (Tartumaa)
Pamma	Pamma
Panga	Panga
Pangodi	Pangodi
Pančevo	Pančevo
Papsaare	Papsaare
Pariisis	Paris
Pariis	Paris
Paris	Paris
Paris [etc.]	Paris
Paris?	Paris
Париж	Paris
Париж?	Paris
Parksepa	Parksepa
Parksepa (Võrumaa)	Parksepa
Parksi	Parksi
Parkville (Vic.)	Parkville (Vic.)
Parramatta	Parramatta
Partille (Rootsi)	Partille (Rootsi)
Paterson	Paterson
Paterson, New Jersey	Paterson
Peterson (New Jersey)	Paterson
Patküla [Valgamaa]	Patküla [Valgamaa]
Pau	Pau
Pauastvere (Jõgevamaa)	Pauastvere (Jõgevamaa)
Paunküla (Harjumaa)	Paunküla (Harjumaa)
Pearland (Texas)	Pearland (Texas)
Pedase (Harjumaa)	Pedase (Harjumaa)
Pedaspää (Meeksi vald)	Pedaspää (Meeksi vald)
Peedu	Peedu
Tuuka-Peedu	Peedu
Peetri	Peetri
Peetri (Harjumaa)	Peetri
Peetri [Harjumaa]	Peetri
Peetri alevik, Harjumaa	Peetri
Rae vald, [Peetri]	Peetri
Tallinn [p.o. Tartu]	Peetri
Пеэтри (Harjumaa)	Peetri
Peetri [Järvamaa]	Peetri [Järvamaa]
Peetrimõisa	Peetrimõisa
Peine	Peine
Penig	Penig
Penijõe (Läänemaa)	Penijõe [Läänemaa]
Penijõe [Läänemaa]	Penijõe [Läänemaa]
Penuja	Penuja
Peraküla	Peraküla
Peri	Peri
Perila	Perila
Perm	Perm
Permis	Perm
Пермь	Perm
Pest	Pest
Pesth	Pesth
Peterborough	Peterborough
Новый Петергоф	Peterhof
Peterhof	Peterhof
Petersberg	Petersberg
Petroskoi	Petrozavodsk
Петрозаводск	Petrozavodsk
Petser	Petser
Petserimaa	Petser
Печеры	Petser
Печеры?	Petser
Petseri	Petseri
Petseris	Petseri
Петсери	Petseri
Печоры	Petseri
Pfaffenhofen	Pfaffenhofen
Pfaffenhofen/Ilm	Pfaffenhofen/Ilm
Pforzheim	Pforzheim
Pfullingen	Pfullingen
Philadelphia	Philadelphia
Philadelphia (Pa.)	Philadelphia
Wilmington-Philadelphia	Philadelphia
Philadelphia (Wilmington)	Philadelphia (Wilmington)
Piaseczno	Piaseczno
Picton (Austraalia)	Picton (Austraalia)
Pieksämäki	Pieksämäki
Pierre (S.Dak.)	Pierre (S.Dak.)
Pierrefonds (Quebec)	Pierrefonds (Quebec)
Pihkva	Pihkva
Pihkwas	Pihkva
Псков	Pihkva
Piira	Piira
Piirsalu	Piirsalu
Piistaoja	Piistaoja
Piistaoja [Pärnumaa]	Piistaoja
Piitsaküla	Piitsaküla
Piitsaküla (Võrumaa)	Piitsaküla
Piitsaküla [Võrumaa]	Piitsaküla
Pikavere	Pikavere
Pikavere [Pärnumaa]	Pikavere [Pärnumaa]
Pikavere küla	Pikavere küla
Pikkjärve küla	Pikkjärve küla
Pilistvere	Pilistvere
Pilistveres	Pilistvere
Pilistweres	Pilistvere
Pilistvere küla	Pilistvere
Pilkengton	Pilkengton
Pinneberg	Pinneberg
Pirgu	Pirgu
Pirgu [Raplamaa]	Pirgu
Pittsburgh	Pittsburgh
Pleskow	Pleskow
Пловдив	Plovdiv
Plymouth	Plymouth
Plön	Plön
Poitiers	Poitiers
In Poland	Poland
Poland	Poland
Poola	Poland
Poolas	Poland
Польша	Poland
Польщi	Poland
Польща	Poland
в Польше	Poland
Polotsk	Polatsk
Polen	Polen
Polli	Polli
Polli [Viljandimaa]	Polli [Viljandimaa]
Полтава	Poltava
Pomáz	Pomáz
Ponce	Ponce
Pori	Pori
Porkuni	Porkuni
Porkuni (Lääne-Virumaa)	Porkuni
Porsa	Porsa küla
Porsa küla	Porsa küla
Port Noarlunga South (Austr.)	Port Noarlunga South (Austr.)
Port Sydney	Port Sydney
Port Townsend	Port Townsend
Portland	Portland
Portland (Oreg.)	Portland
Portland (Oregon)	Portland
Portland (USA)	Portland
Portland [USA]	Portland
Portugal	Portugal
Borga	Porvoo
Borgå	Porvoo
Porvoo	Porvoo
Porvoo [etc.]	Porvoo
Porvoo etc	Porvoo
Porvoossa	Porvoossa
Porwoo	Porwoo
Potsdam	Potsdam
Posen	Poznań
Poznan	Poznań
Poznań	Poznań
Praaze	Praaze
Pragi	Pragi
Prag	Prague
Prague	Prague
Praha	Prague
Praha?	Prague
Прага	Prague
Prange	Prange
Prangli (Harjumaa)	Prangli (Harjumaa)
Prantsusmaa	Prantsusmaa
Preedi	Preedi
Prien/Chiemsee	Prien/Chiemsee
Princeton	Princeton
Princeton (N. J.)	Princeton (N. J.)
Pringi	Pringi
Pringi (Harjumaa)	Pringi (Harjumaa)
Pringi küla (Viimsi)	Pringi (Harjumaa)
Prospect Heights	Prospect Heights (Ill.)
Prospect Heights (Ill.)	Prospect Heights (Ill.)
Providence	Providence
Pudisoo	Pudisoo
Pudisoo küla	Pudisoo
Puhja	Puhja
Puhja (Tartumaa)	Puhja (Tartumaa)
Puhja [Tartumaa]	Puhja (Tartumaa)
Puiatu	Puiatu
Puide	Puide
Puise	Puise
Puka	Puka
Puka [Valgamaa]	Puka [Valgamaa]
Pukamäe	Pukamäe
Pukamäe küla	Pukamäe
Pullach bei München	Pullach bei München
Pulli	Pulli (Pärnumaa)
Pulli (Pärnumaa)	Pulli (Pärnumaa)
Puna küla	Puna küla
Punsa	Punsa
Punsa (Võrumaa)	Punsa
Purila	Purila
Purtse	Purtse
Purtse [Ida-Virumaa	Purtse
Purtsi	Purtsi
Пущино	Pushchino
Puuri	Puuri
Puurmani	Puurmani
Puurmani (Jõgevamaa)	Puurmani
Puurmani [Jõgevamaa]	Puurmani
Päide küla	Päide küla
Päidla	Päidla
Päiksi	Päiksi
Päinurme	Päinurme
Päite	Päite
Pärispea [Harjumaa	Pärispea [Harjumaa
Pärlijõe	Pärlijõe
Pärnamäe	Pärnamäe
Pärnamäe (Harjumaa)	Pärnamäe
Pärnjõe [Pärnumaa]	Pärnjõe [Pärnumaa]
Estonia, [Pärnu]	Pärnu
Pernau	Pärnu
Pernau?	Pärnu
Pernov	Pärnu
Pernu	Pärnu
Pernus	Pärnu
Perno	Pärnu
Perno-linnas	Pärnu
Pärnu	Pärnu
Pärnu?	Pärnu
Pärnus	Pärnu
Pärnu (Pernau)	Pärnu
Pärnu linn	Pärnu
Taaratamme talu (Pärnumaa)	Pärnu
Пернов	Pärnu
Пернов?	Pärnu
Пярну	Pärnu
Пярну, Эстония	Pärnu
Halinga	Pärnu-Jaagupi
Pärnu-Jaagupi	Pärnu-Jaagupi
Wiru-Jakobi	Pärnu-Jaagupi
Pärnumaa	Pärnumaa
Лаади (Pärnumaa)	Pärnumaa
Pärsti	Pärsti
Pärsti [Viljandimaa]	Pärsti
Päärna	Päärna
Pécs	Pécs
Põlgaste	Põlgaste
Põlliku	Põlliku
Põllu küla	Põllu küla
Põltsamaa (Jõgevamaa)	Põltsamaal
Põltsamaa [Jõgevamaa]	Põltsamaal
Põltsamaal	Põltsamaal
Оберпален	Põltsamaal
Пыльтсамаа	Põltsamaal
Põlula	Põlula
Põlula [Lääne-Virumaa]	Põlula
Põlva	Põlva
Põlvas	Põlva
Põlvamaa	Põlvamaa
Põlvamaal	Põlvamaal
Põvvatu	Põvvatu
Põides	Pöide
Pöide	Pöide
Pößneck	Pößneck
Pühajärve	Pühajärve
Pühajärve [Valgamaa]	Pühajärve
Pühalepa	Pühalepa
Pühalepa [Hiiumaa]	Pühalepa
Pühaste	Pühaste
Pürksi	Pürksi
Pürksi (Läänemaa)	Pürksi
Pürksi [Läänemaa]	Pürksi
Püssi	Püssi
[Lüganuse] Virumaa	Püssi
Püünsi	Püünsi
Püünsi (Harjumaa)	Püünsi
Rohuneeme	Püünsi
Płońsk	Płońsk
Quedlingen	Quedlingen
Queens Village (New Jersey)	Queens Village (New Jersey)
Québec	Québec
Raadi	Raadi
Harju-Jaani	Raasiku
Raasiku	Raasiku
Raasiku vald	Raasiku
Rae	Rae
Rae (Harjumaa)	Rae
Rae [Harjumaa]	Rae
Rae vald	Rae
Raela	Raela
Rahula	Rahula
Raikküla	Raikküla
Raikküla [Raplamaa]	Raikküla
Raiste	Raiste
Raja küla (Jõgevamaa)	Raja küla (Jõgevamaa)
Rajamäki	Rajamäki
Rakke	Rakke [Lääne-Virumaa]
Rakke [Lääne-Virumaa]	Rakke [Lääne-Virumaa]
Rakvere	Rakvere
Rakvere?	Rakvere
Rakveres	Rakvere
Rakwere	Rakvere
Rakweres	Rakvere
Rakwere-Wesenberg	Rakvere
Wesenberg	Rakvere
[Rakvere,] Lääne-Virumaa	Rakvere
Везенберг	Rakvere
Раквере	Rakvere
Раменское	Ramenskoye
Ramsgate	Ramsgate
Ramsi	Ramsi
Randers	Randers
Randers [Taani]	Randers
Randivälja	Randivälja
Randvere	Randvere
Randvere [Harjumaa]	Randvere [Harjumaa]
Randvere küla	Randvere [Harjumaa]
Randveres [Harjumaa]	Randvere [Harjumaa]
Rannamõisa	Rannamõisa
Rapla	Rapla
Raplas	Rapla
Рапла	Rapla
Raplamaa	Raplamaa
Rapperswil	Rapperswil
Rassi [Viljandimaa]	Rassi [Viljandimaa]
Rasva (Võrumaa)	Rasva (Võrumaa)
Ratla	Ratla
Ratzeburg	Ratzeburg
Raudna	Raudna [Viljandimaa]
Raudna [Viljandimaa]	Raudna [Viljandimaa]
Rauma	Rauma
Rebala	Rebala
Recht	Recht
Redwood City, California	Redwood City, California
Refwel	Refwel
Regensburg	Regensburg
Regenspurg	Regensburg
Rehburg-Loccum	Rehburg-Loccum
Rehemetsa	Rehemetsa
Reheselja (Hiiumaa)	Reheselja (Hiiumaa)
Reinbek	Reinbek bei Hamburg
Reinbek bei Hamburg	Reinbek bei Hamburg
Reinu (Pärnumaa)	Reinu (Pärnumaa)
Rekkem [Madalmaad]	Rekkem [Madalmaad]
Remagen-Oberwinter	Remagen-Oberwinter
Rennes	Rennes
Reo	Reo
Reo (Saaremaa)	Reo küla
Reo küla	Reo küla
Reola	Reola
Reopalu	Reopalu
Retla	Retla
Reutlingen	Reutlingen
Rewal	Rewal
Reykajvík	Reykajvík
Reykjavik	Reykjavík
Reykjavík	Reykjavík
Rezekne [Läti]	Rezekne [Läti]
Rēzekne [jne.]	Rezekne [Läti]
Rheinbach	Rheinbach
Rheinbreitbach	Rheinbreitbach
Rian	Rian
Richmond	Richmond
Richmond [USA]	Richmond
Richmond (Victoria)	Richmond (Victoria)
Richmond, Victoria	Richmond (Victoria)
Ridala	Ridala
Ridalas	Ridala
Ridala vald	Ridala vald
RIGA	Riga
(Riga	Riga
Leipzig-Riga	Riga
Ria	Riga
In Riga	Riga
Riga	Riga
Riga Linnas	Riga
Riga [etc.]	Riga
Riga etc	Riga
Riga?	Riga
Rigas	Riga
Riga : W. F. Häcker	Riga
Riga-Dorpat	Riga
Rigæ	Riga
[Riga]?	Riga
in Riga	Riga
zu Riga	Riga
Rigae	Riga
Rigā	Riga
Ria Linnas	Riga
Rias	Riga
Riia	Riga
Riia linnas	Riga
Riia?	Riga
Riias	Riga
Riigas	Riga
Rija linnas	Riga
Rija-linnas	Riga
Rijas-Lossis	Riga
Riika	Riga
Rija	Riga
Rijas	Riga
Ryga	Riga
Rîga	Riga
Rīga	Riga
Rīgā	Riga
Рига	Riga
Рига?	Riga
Rihga	Rihga
Riidaja	Riidaja
Riidaku küla	Riidaku küla
Riihimäki	Riihimäki
Nissi	Riisipere
Riisipere	Riisipere
Rija linnan	Rija linnan
Rija-linan	Rija-linan
Rijan	Rijan
Rijswijk	Rijswijk
Rindal	Rindal
Rinteln	Rinteln
Rio de Janeiro	Rio de Janeiro
Risti	Risti
Risti (Läänemaa)	Risti (Läänemaa)
Risti [Läänemaa]	Risti (Läänemaa)
Ristiküla	Ristiküla
Roela [Lääne-Virumaa	Ristiküla
Roela [Lääne-Virumaa]	Ristiküla
Ristil	Ristil
Ristipalo (Põlvamaa)	Ristipalo (Põlvamaa)
Ritsiku	Ritsiku
Riverside (Cal.)	Riverside (Cal.)
Rixensart	Rixensart
Riyadh	Riyadh
Rochester	Rochester
Rockville (Maryland)	Rockville (Maryland)
Rockville, (Maryland)	Rockville (Maryland)
Rocky Harbour (N.L.)	Rocky Harbour (N.L.)
Rodez	Rodez
Roela	Roela
Роэла	Roela
Rohu	Rohu
Rohuneeme (Harjumaa)	Rohuneeme (Harjumaa)
Romae ad S. Sabinae	Romae ad S. Sabinae
Rom	Rome
Roma	Rome
Rome	Rome
Rooma	Rome
Roobaka	Roobaka
Roobaka küla (Saaremaa vald)	Roobaka
Saaremaa, Roobaka	Roobaka
Roobe küla	Roobe küla
Roosiku (Võrumaa)	Roosiku (Võrumaa)
Roosna	Roosna
Roosna-Alliku	Roosna-Alliku
Roosna-Alliku [Järvamaa]	Roosna-Alliku
Rootsiküla	Rootsiküla
Rosenheim	Rosenheim
Roskilde	Roskilde
Roskilde [Denmark]	Roskilde
Rostochi[i]	Rostochi[i]
Rostochii	Rostock
Rostock	Rostock
Ростов-На-Дону	Rostov-na-Donu
Ростов-на-Дону	Rostov-na-Donu
Rothenburg	Rothenburg ob der Tauber
Rottenburg am Neckar	Rottenburg am Neckar
Rotterdam	Rotterdam
Rovaniemi	Rovaniemi
Rozelle	Rozelle
Rudkøbing	Rudkøbing
Rudolstadt	Rudolstadt
Ruhingu	Ruhingu
Ruhingu (Võrumaa)	Ruhingu
Ruhingu küla	Ruhingu
Ruhnu	Ruhnu
Ruhnus	Ruhnu
Ruien	Ruien
Rujen	Rujen
Rupsi	Rupsi
Rupsi (Tartumaa)	Rupsi küla
Rupsi küla	Rupsi küla
Ruse	Ruse
Русе	Ruse
Русе (Bulgaaria)	Ruse
Russalka (Tallinn)	Russalka (Tallinn)
Russalu	Russalu
Ruu	Ruu
Ruu küla	Ruu küla
Ruusa [Põlvamaa]	Ruusa [Põlvamaa]
Ruusmäe	Ruusmäe
Ruusmäe (Võrumaa)	Ruusmäe
Ruusmäe [Võrumaa]	Ruusmäe
Рязань	Ryazan’
Rzeszów	Rzeszów
Räestu	Räestu
Ossipe [Võrumaa]	Räestu [Võrumaa]
Räestu [Võrumaa]	Räestu [Võrumaa]
Võrun	Räestu [Võrumaa]
Räpina	Räpina
Räpina (Põlvamaa)	Räpina
Räpina [Põlvamaa]	Räpina
Räpinä	Räpina
Räägu	Räägu
Rõngu	Rõngu
Rõngu [Tartumaa]	Rõngu
Rõngu vald	Rõngu
Rõuge	Rõuge [Võrumaa]
Rõuges	Rõuge [Võrumaa]
Rõuge [Võrumaa]	Rõuge [Võrumaa]
Röhsska	Röhsska
Rødovre	Rødovre
Ronne	Rønne
Rønne	Rønne
Rezekne	Rēzekne
Rēzekne	Rēzekne
Резекне	Rēzekne
Saarbrücken	Saarbrücken
Saarbrücken [Saksamaa]	Saarbrücken
Saarbücken	Saarbrücken
Saarde-Pärnu	Saarde-Pärnu
Saare (Läänemaa)	Saare (Läänemaa)
Saare [vald, Kääpa]	Saare [vald, Kääpa]
Saare küla	Saare küla
Saare küla (Jõgevamaa)	Saare küla (Jõgevamaa)
Saaremaa	Saaremaa
Saaremaa?	Saaremaa
Госстрой Эстонской ССР	Saaremaa
Эзель	Saaremaa
Kuresaar	Saaremaa, [Kuressaare]
Kuresaar [s.o. Kuressaare	Saaremaa, [Kuressaare]
Kuresaar [s.o. Kuressaare]	Saaremaa, [Kuressaare]
Kuressaare linn	Saaremaa, [Kuressaare]
Kurresaar	Saaremaa, [Kuressaare]
Saaremaa, [Kuressaare]	Saaremaa, [Kuressaare]
Saaremetsa	Saaremetsa
Saarijärvi	Saarijärvi
Saatse	Saatse
Sacramento	Sacramento
Sadala	Sadala
Sadala (Jõgevamaa)	Sadala
Tabivere (Jõgevamaa)	Sadala
Saduküla	Saduküla
Sagadi	Sagadi
Sagadi [Lääne-Virumaa	Sagadi [Lääne-Virumaa]
Sagadi [Lääne-Virumaa]	Sagadi [Lääne-Virumaa]
Saia	Saia
Saia (Saaremaa)	Saia (Saaremaa)
Peeterburis [!]	Saint Petersburg
Peterburg	Saint Petersburg
Peterburis	Saint Petersburg
Peterburi	Saint Petersburg
Petersburg	Saint Petersburg
Petrograd	Saint Petersburg
Petrogradis	Saint Petersburg
Pietari	Saint Petersburg
Saint-Pétersbourg	Saint Petersburg
Sankt Peterburg	Saint Petersburg
Sankt Petersburg	Saint Petersburg
Sankt-Peterburg	Saint Petersburg
Sankt-Petersburg	Saint Petersburg
Sint-Petersburg	Saint Petersburg
Peeterburgis	Saint Petersburg
Pehterburgs	Saint Petersburg
Peterpurgis	Saint Petersburg
St. Peeterburis	Saint Petersburg
St. Peterburg	Saint Petersburg
St. Peterburis	Saint Petersburg
(С.-Петербург	Saint Petersburg
C.-Петербург	Saint Petersburg
C.-Петербург?	Saint Petersburg
Caнкт-Петербург	Saint Petersburg
Cанкт-Петербург	Saint Petersburg
Leeningradis [!]	Saint Petersburg
Leningrad	Saint Petersburg
Leningradis	Saint Petersburg
St. Peeterburg	Saint Petersburg
St. Peterburi	Saint Petersburg
St. Petersburg	Saint Petersburg
St. Petersburg [etc.]	Saint Petersburg
St. Petersburg?	Saint Petersburg
St. Petersburg [i. e. Berlin]	Saint Petersburg
St. Pétersbourg	Saint Petersburg
St. Pétersbourg?	Saint Petersburg
St. Pétersbourg : Imprimerie de l'Académie Impériale des sciences	Saint Petersburg
St. Pétersbourg [etc]	Saint Petersburg
St.-Petersburg	Saint Petersburg
St.-Petersburg [etc.]	Saint Petersburg
St.Petersburg	Saint Petersburg
Петербург	Saint Petersburg
С,-Петербург	Saint Petersburg
С-Петербург	Saint Petersburg
С. Петербург	Saint Petersburg
С.- Петербург	Saint Petersburg
С.-Петербург	Saint Petersburg
С.-Петербург?	Saint Petersburg
С.-Петербургская губ. тип.	Saint Petersburg
Санкт Петербург	Saint Petersburg
Санкт-Петербург	Saint Petersburg
Санкт-Петербургъ	Saint Petersburg
СанктПетербургъ	Saint Petersburg
St.-Pétersboug[!	Saint Petersburg
St.-Pétersbourg	Saint Petersburg
St.-Pétersbourg [etc.]	Saint Petersburg
Ленинград	Saint Petersburg
Ленинград?	Saint Petersburg
Петрогад	Saint Petersburg
Петроград	Saint Petersburg
Saint-Estève	Saint-Estève
Saint-Malo	Saint-Malo
Saka	Saka
Saksamaa	Saksamaa
Saksamaa?	Saksamaa
Saksamaal	Saksamaal
Saku	Saku [Harjumaa]
Sakus	Saku [Harjumaa]
Saku [Harjumaa]	Saku [Harjumaa]
Sakus [Harjumaa]	Saku [Harjumaa]
Саку	Saku [Harjumaa]
Salamanca	Salamanca
Саласпилс	Salaspils
Salinas(California)	Salinas(California)
Salisburg	Salisburg
Salla	Salla
Salme	Salme
Salme [Saare maakond]	Salme
Salmistu	Salmistu
Salmistu (Harjumaa)	Salmistu
Salo	Salo
Salt Lake City	Salt Lake City
Saltsjö-Boo	Saltsjö-Boo
Saltsjöbaden	Saltsjöbaden
Salutaguse	Salutaguse [Järva maakond]
Salutaguse [Järva maakond]	Salutaguse [Järva maakond]
Salzburg	Salzburg
Самохваловичи	Samakhvalavichy
Sammaljoki	Sammaljoki
Sampzon	Sampzon
San Bernardino (CA)	San Bernardino (CA)
San Bernardino (Calif.)	San Bernardino (CA)
San Diego	San Diego
San Diego ... [etc.]	San Diego
San Domenica [Italy]	San Domenica [Italy]
San Domenico	San Domenico
San Domenico [Italy]	San Domenico
San Domenico di Fiesole	San Domenico di Fiesole
San Francisco	San Francisco,
San Francisco,	San Francisco,
San Jose (Calif.)	San Jose (Calif.)
San Juan Capistrano (CA)	San Juan Capistrano (CA)
Sandhem	Sandhem
Sandisuu	Sandisuu
Sandomierz	Sandomierz
Sangaste	Sangaste
Sankt Augustin	Sankt Augustin
St. Gallen	Sankt Gallen
Santa Ana	Santa Ana (Ameerika Ühendriigid)
Santa Ana (Ameerika Ühendriigid)	Santa Ana (Ameerika Ühendriigid)
Santa Barbara (California)	Santa Barbara (Kalifornia)
Santa Barbara (Kalifornia)	Santa Barbara (Kalifornia)
Tenerife	Santa Cruz de Tenerife
Santa Monica (Cal.)	Santa Monica (Cal.)
Santiago de Chile	Santiago
Santiago de Compostela	Santiago de Compostela
Саранск	Saransk
Саратов	Saratov
Sargvere	Sargvere
Sargvere (Järvamaa)	Sargvere
Saru (Võrumaa)	Saru (Võrumaa)
Saru küla	Saru (Võrumaa)
Sarve	Sarve
Sarvela	Sarvela
Sassukvere (Jхgevamaa)	Sassukvere (Jхgevamaa)
Saue	Saue
Saue (Harjumaa)	Saue
Saue [Harjumaa]	Saue
Сауэ	Saue
Sauga	Sauga
Saula	Saula
Saula (Harjumaa)	Saula (Harjumaa)
Saula (Kose vald)	Saula (Harjumaa)
[Saula (Kose vald])	Saula (Harjumaa)
Saunja küla (Lääne-Nigula vald)	Saunja küla (Lääne-Nigula vald)
Savariae	Savariae
Saverna	Saverna (Põlvamaa)
Saverna (Põlvamaa)	Saverna (Põlvamaa)
Savimäe	Savimäe
Saviranna	Saviranna
Sawtry	Sawtry
Scarborough	Scarborough
Scarborough (Ontario)	Scarborough (Ontario)
Schaffhausen	Schaffhausen
Scheßlitz	Scheßlitz
Schlesswig	Schlesswig
Schleswig	Schleswig
Schmalkalden	Schmalkalden
Schwabach	Schwabach
Schwarzenbeck	Schwarzenbeck
Schwarzenbek	Schwarzenbek
Schwerin	Schwerin
Schoenberg	Schönberg
Seaside	Seaside
Seattle	Seattle
Seattle?	Seattle
Seattle (Wash.)	Seattle
Seattle, WA	Seattle
Seedrioru	Seedrioru
Sejny	Sejny
Seliste	Seliste
Seljametsa	Seljametsa
Seltjarnarnes	Seltjarnarnes
Seoul	Seoul
Soul	Seoul
Serga	Serga (Võrumaa)
Serga (Võrumaa)	Serga (Võrumaa)
Serga (Võrumaal)	Serga (Võrumaa)
Serga [Võrumaa]	Serga (Võrumaa)
Serga küla (Võrumaa)	Serga (Võrumaa)
Сергиев Посад [Россия]	Sergiyev Posad
Сергиев Посад	Sergiyev Posad
Setomaa	Setomaa
Sewickley, Pennsylvania	Sewickley, Pennsylvania
Shanghai	Shanghai
Shenzhen	Shenzhen
Siegen	Siegen
Sigaste	Sigaste
Sigtuna	Sigtuna
Sihva (Valgamaa)	Sihva [Valgamaa]
Sihva [Valgamaa	Sihva [Valgamaa]
Sihva [Valgamaa]	Sihva [Valgamaa]
Siimusti	Siimusti
Siimusti (Jõgevamaa)	Siimusti (Jõgevamaa)
[Siimusti] (Jõgevamaa)	Siimusti (Jõgevamaa)
Sillamäe	Sillamäe
Силламяэ	Sillamäe
Sillaotsa (Tartumaa)	Sillaotsa (Tartumaa)
Sillapää	Sillapää
Silver Spring	Silver Spring (Maryland)
Silver Spring (Maryland)	Silver Spring (Maryland)
Silver Spring, Maryland	Silver Spring (Maryland)
Silver Spring, Md	Silver Spring (Maryland)
Симферополь	Simferopol
Simisti	Simisti
Simuna	Simuna
Sindi	Sindi
Sindi [Pärnumaa	Sindi
Singapore	Singapore
Singapore [etc.]	Singapore
Singapour	Singapore
Singapur	Singapore
Singapuris	Singapore
Sinimäe	Sinimäe
Sinimäe [Ida-Virumaa]	Sinimäe [Ida-Virumaa]
Sinzig	Sinzig
Sipe	Sipe (Tartumaa)
Sipe (Tartumaa)	Sipe (Tartumaa)
Sirgu	Sirgu
Sirguvere	Sirguvere
Siuro	Siuro
Siuro, Nokia	Siuro
Skagen [Taani]	Skagen [Taani]
Skara	Skara
Skellefteå	Skellefteå
Shkup	Skopje
Skopje	Skopje
Скопje	Skopje
Скопjе	Skopje
Скопје	Skopje
Скривери	Skrīveri
Skärholmen, Sweden	Skärholmen, Sweden
Sloatsburg, New York	Sloatsburg, New York
Smolensk	Smolensk
Смоленск	Smolensk
Soesaare (Põlvamaa)	Soesaare (Põlvamaa)
Sofia	Sofia
София	Sofia
Soinaste	Soinaste (Tartumaa)
Soinaste (Tartumaa)	Soinaste (Tartumaa)
Soinaste [Tartumaa]	Soinaste (Tartumaa)
Soitsjärve	Soitsjärve
Сухуми	Sokhumi
Solna (Rootsi)	Solna (Rootsi)
Sommerville, Mass	Sommerville, Mass
Sonda	Sonda
Soodla	Soodla
Soomaa	Soomaa
Soome	Soome
Soome?	Soome
Soomes	Soome
Soonlepa	Soonlepa
Soontaga	Soontaga
Sootaga	Sootaga
Sopot	Sopot
Sortavala	Sortavala
South Croydon, Surrey	South Croydon, Surrey
Baden	South San Francisco
Tilsit	Sovetsk
St-Peeterburg	St-Peeterburg
St. Petersburg, Florida	St-Peeterburg
St. Catharines	St. Catharines
St. Ingbert	St. Ingbert
St. Katharinen	St. Katharinen
St. Louis (Mo.)	St.Louis, Missouri
St.Louis, Missouri	St.Louis, Missouri
Stade	Stade
Stanford (Calif.)	Stanford (Calif.)
Stanford (California)	Stanford (Calif.)
Starnberg	Starnberg
Stavanger	Stavanger
Berlin-Steglitz	Steglitz
Steglitz	Steglitz
Estocolmo	Stockholm
Holmia	Stockholm
Holmiae	Stockholm
Holmiae?	Stockholm
Sockholm	Stockholm
Sto[c]kholm	Stockholm
Stochkholm	Stockholm
Stockholm	Stockholm
Stockholm [etc.]	Stockholm
Stockholm etc	Stockholm
Stockholm?	Stockholm
Stockholmis	Stockholm
Stokholmis	Stockholm
Stockholm] : [s.n.	Stockholm
Stockholm] :[s.n.	Stockholm
Stockhom	Stockholm
Stockolm	Stockholm
Stokholm	Stockholm
Stokholm (p.o. Stockholm)	Stockholm
Tukholma	Stockholm
Tukholmassa	Stockholm
Стокгольм	Stockholm
Stockport	Stockport
Stolberg a.H	Stolberg a.H
Stollhamm	Stollhamm
Stolzenau	Stolzenau
Strasbourg	Strasbourg
Strassburg	Strasbourg
Strasshof [etc.]	Strasshof an der Nordbahn
Stroud	Stroud
Stregnesiae	Strängnäs
Strängnäs	Strängnäs
Stuttgart	Stuttgart
Stuttgart [etc.]	Stuttgart
Stutttgart	Stuttgart
Stärholmen	Stärholmen
Subiaco	Subiaco
Suffolk	Suffolk
Suigu	Suigu
Suislepa	Suislepa
Suislepas [Viljandimaa]	Suislepa
Sulu	Sulu
Sundsvall	Sundsvall
Suolahti	Suolahti
Surju	Surju
Sutlema	Sutlema
Sutlema (Raplamaa)	Sutlema (Raplamaa)
Suure-Jaani	Suure-Jaani
Suure-Jaanis	Suure-Jaani
Suures-Jaanis	Suure-Jaani
Suure-Jaani (Viljandimaa)	Suure-Jaani
Suure-Kõpu	Suure-Kõpu
Suure-Lähtru [Läänemaa]	Suure-Lähtru [Läänemaa]
Suuremetsa	Suuremetsa
Suuremõisa	Suuremõisa
Suurpea	Suurpea
Suurupi	Suurupi
Suurupi (Harjumaa)	Suurupi
Suurupi [Harjumaa	Suurupi
Suurupi [Harjumaa]	Suurupi
Svelvik [Norra]	Svelvik [Norra]
Svenljunga	Svenljunga
Abertawe	Swansea
Sverige	Sweden
Sverige?	Sweden
Rootsi	Sweden
Sweden	Sweden
Sidney	Sydney
Sidney?	Sydney
Sydney	Sydney
Sydneys	Sydney
Сыктывкар	Syktyvkar
Syracuse (N.Y.)	Syracuse (N.Y.)
Stettin	Szczecin
Szczecin	Szczecin
Szeged	Szeged
Szentendre	Szentendre
Szentendre [Ungari]	Szentendre
Szolnok	Szolnok
Savariae [i.e. Szombathely]	Szombathely
Szombathely	Szombathely
Szombathely [Ungari]	Szombathely
São Paolo	São Paulo
São Paulo	São Paulo
Sänna	Sännä [Võrumaa]
Sännä [Võrumaa]	Sännä [Võrumaa]
Särevere	Särevere
Türi	Särevere
Тюри	Särevere
Särgla	Särgla
Sävedalen	Sävedalen
Sääritsa	Sääritsa
Sääsküla	Sääsküla
Sääsküla (Järvamaa)	Sääsküla (Järvamaa)
Sånga-Säby	Sånga-Säby
Se	Sées
Sõmera	Sõmera
Sõmerpalu	Sõmerpalu
Sõmerpalus	Sõmerpalu
Sõmerpalu (Võrumaa)	Sõmerpalu
Sõmeru	Sõmeru
Sõmeru (Lääne-Virumaa)	Sõmeru (Lääne-Virumaa)
Sõmeru [Lääne-Virumaa	Sõmeru (Lääne-Virumaa)
Sõmeru [Lääne-Virumaa]	Sõmeru (Lääne-Virumaa)
Sõru ots	Sõru ots
Söderköping	Söderköping
Söderköping [Rootsi	Söderköping
Södertälje	Södertälje
Kabila (Viljandimaa)	Sürgavere
Sürgavere	Sürgavere
Sürgavere (Viljandimaa)	Sürgavere
Ala	Taagepera
Taagepera	Taagepera
Taagepera [(Valgamaa)	Taagepera [(Valgamaa)
Taagepera [Valgamaa]	Taagepera [(Valgamaa)
Taageperas [Valgamaa]	Taagepera [(Valgamaa)
Taani	Taani
Taani?	Taani
Taaralinn	Taaralinn
Taastrup	Taastrup
Taavetti?	Taavetti
Tabasalu	Tabasalu
Tabasalu (Harjumaa)	Tabasalu
Tabasalu [Harjumaa]	Tabasalu
Табасалу	Tabasalu
Tabivere	Tabivere
Voldi	Tabivere
Tacoma (Wash.)	Tacoma (Wash.)
Taebla	Taebla
Taeblas	Taebla
Taebla [Läänemaa]	Taebla
Taebla alevik	Taebla
Taejeon	Taejeon
Taevaskoja	Taevaskoja
Таганрог	Taganrog
Taheva	Taheva
Tahkuranna	Tahkuranna
Tahkurannas	Tahkuranna
Taibei (Taiwan)	Taibei (Taiwan)
Taipei	Taipei
Taizé	Taizé
Takoma Park (Cal.)	Takoma Park (Cal.)
Takoma Park [USA]	Takoma Park [USA]
Takoma Park, Md	Takoma Park [USA]
Taldykorgan [s.o. Taldõkorgan]	Taldykorgan [s.o. Taldõkorgan]
Tali [Pärnumaa]	Tali [Pärnumaa]
Talli	Talli
Talliinan	Talliinan
Eesti [Tallinn]	Tallinn
Eesti, [Tallinn	Tallinn
Eesti, [Tallinn]	Tallinn
En Tallinn	Tallinn
Estland [Tallinn]	Tallinn
Halifax [i.e. Tallinn]	Tallinn
Helsinki [i.e. Таллинн]	Tallinn
Kalevilinnas [s.o. Tallinn	Tallinn
Külaküla (Tallinn)	Tallinn
Maardu [Tallinn]	Tallinn
REVAL	Tallinn
Revel	Tallinn
Réval	Tallinn
TALLINN	Tallinn
Taanilinn	Tallinn
TalLinn	Tallinn
Talin	Tallinn
Talinn	Tallinn
Tallin	Tallinn
Tallin[n]	Tallinn
Tallina	Tallinn
(Reval	Tallinn
([Reval	Tallinn
Darinnen gedruckt [i.e. zu Reval]	Tallinn
Gedruckt in Revall	Tallinn
Gedruckt zu Revall	Tallinn
Ibidem [Reval]	Tallinn
In Reval	Tallinn
Reval	Tallinn
Reval etc	Tallinn
Reval-Schloss	Tallinn
Reval?	Tallinn
Reval ?	Tallinn
Reval - Tallinn	Tallinn
Reval :[	Tallinn
Reval :[s.n.]	Tallinn
Reval [	Tallinn
Reval [Tallinn]	Tallinn
Reval [i. e. Dresden]	Tallinn
Reval [i. e. Erfurt]	Tallinn
Reval [i.e. Riga]	Tallinn
Reval,	Tallinn
Reval,[s.n.]	Tallinn
Reval: [A.Simon]	Tallinn
Reval] :[C. Brendeken	Tallinn
Revalia	Tallinn
Revaliae	Tallinn
Revall	Tallinn
Talinas	Tallinn
Tallinn	Tallinn
Tallinn [etc.]	Tallinn
Tallinn etc	Tallinn
Tallinn?	Tallinn
Tallinna linnas	Tallinn
Tallinnas	Tallinn
Tallinn (Reval	Tallinn
Tallinn (Reval)	Tallinn
Tallinn-Reval	Tallinn
Tallinnas (Reval)	Tallinn
Taллинн	Tallinn
Tryckt i Reval	Tallinn
Zu Revall	Tallinn
in Reval	Tallinn
Академия наук Эстонии	Tallinn
Таllinn	Tallinn
Tallinn (Ревель)	Tallinn
Tallinn - Saatse	Tallinn
Tallinn ... [jne.]	Tallinn
Tallinn [etc.	Tallinn
Tallinn [etc]	Tallinn
Tallinn [jne.]	Tallinn
Tallinn [jt.]	Tallinn
Tallinn [p.o. Saksamaa]	Tallinn
Tallinn, Estonia	Tallinn
Tallinn/Karlsruhe	Tallinn
Tallinn[	Tallinn
Tallinna	Tallinn
Tallinnan	Tallinn
Tallinnassa	Tallinn
Talllinn	Tallinn
Taллин	Tallinn
Tаллинн	Tallinn
[Tallin]n	Tallinn
[Tallinn]	Tallinn
[Таллин : Горьковский государственный университет]	Tallinn
tallinn	Tallinn
À Tallinn	Tallinn
Ревель	Tallinn
Ревель?	Tallinn
Тallinn	Tallinn
Талiн	Tallinn
Талин	Tallinn
Талинн	Tallinn
Таллiн	Tallinn
Таллiнн	Tallinn
Таллиин	Tallinn
Таллиинн	Tallinn
Таллин	Tallinn
Таллин(н)	Tallinn
Таллин[н	Tallinn
Таллин[н]	Tallinn
Таллинн	Tallinn
Таллинн?	Tallinn
Таллинн (Ревель)	Tallinn
Таллинн [и т.д.]	Tallinn
Таллинн, Эстония	Tallinn
Таллинн-Ревель	Tallinn
Таллиннъ	Tallinn
Талллин	Tallinn
Талллинн	Tallinn
Таллінн	Tallinn
Эстония, Таллинн	Tallinn
г. Ревель	Tallinn
Tallinn - Särghaua	Tallinn - Särghaua
Tallinn, Mustamäe	Tallinn, Mustamäe
[Tallinn] : Tallinna Raamatutrükikoda	Tallinn, Mustamäe
Talsingi	Talsingi
Talsinki	Talsinki
Tammemäe	Tammemäe
Tammevaldma	Tammevaldma (Tartumaa)
Tammevaldma (Tartumaa)	Tammevaldma (Tartumaa)
Tammiku	Tammiku
Tammiku (Ida-Virumaa)	Tammiku (Ida-Virumaa)
Tammisaari	Tammisaari
Tammiste	Tammiste
Tammiste [Pärnumaa]	Tammiste
Tammistu	Tammistu
Tammistu (Tartumaa)	Tammistu
Tammneeme	Tammneeme
Tammneeme (Harjumaa)	Tammneeme
Tammneeme küla	Tammneeme
Tampere	Tampere
Tampereella	Tampereella
Tamsalu	Tamsalu
Tamsalu vald	Tamsalu
Tamse [Saaremaa]	Tamse [Saaremaa]
Tanska	Tanska
Tapa	Tapa
Tapal	Tapa
Тапа	Tapa
Tapa vald	Tapa vald
Tarbja (Järvamaa)	Tarbja (Järvamaa)
Taritu [Saare maakond]	Taritu [Saare maakond]
Tarragona	Tarragona
Tarset	Tarset
Tarset (Northumberland)	Tarset
Tarto-Linan trükkitu nink müwwa Grentsiusse man	Tarto-Linan trükkitu nink müwwa Grentsiusse man
Tarto linan	Tarto-linan
Tarto-Linan	Tarto-linan
Tarto-linan	Tarto-linan
Tartolinan	Tarto-linan
Tartoh	Tartoh
Derpt	Tartu
Dorpat	Tartu
Dorpat [etc.]	Tartu
Dorpat?	Tartu
In Dorpat	Tartu
Dorpat (Estland)	Tartu
Dorpat (Tartu)	Tartu
Dorpat :[Academia Gustaviana]	Tartu
Dorpat [etc,]	Tartu
Dorpat:b[s.n.]	Tartu
Dorpat] : [s.n.	Tartu
Ihaste	Tartu
Iourieff (Dorpat)	Tartu
Jourieff (Dorpat)	Tartu
Jujew (Dorpat)	Tartu
Tarbatu	Tartu
Tarto	Tartu
Tarto Linnas	Tartu
Tarto linnas	Tartu
Tarto-Linnas	Tartu
Tarto-linnas	Tartu
Tartos	Tartu
Tarto [Tartu]	Tartu
Tartto	Tartu
Darpata	Tartu
Dorpat (Jurjew	Tartu
Dorpat-Jurjew	Tartu
Dorpati Livon	Tartu
Dorpati Livonorum	Tartu
Dorpati Lovonorum	Tartu
Iouriew	Tartu
Iurievi (Dorpati)	Tartu
Iurievi Livonorum	Tartu
Ivrievi	Tartu
Ivrievi Livonorvm	Tartu
Juriew	Tartu
Jurjeff	Tartu
Jurjeff (Dorpat)	Tartu
Jurjev	Tartu
Jurjevis	Tartu
Jurjev (Dorpat)	Tartu
Jurjev-Tartu	Tartu
Jurjew	Tartu
Jurjew?	Tartu
Jurjewis	Tartu
Jurjew (Dorpat	Tartu
Jurjew (Dorpat)	Tartu
Jurjew(Dorpat	Tartu
Jurjew(Dorpat)	Tartu
Jurjew-Dorpat	Tartu
Jurjewa	Tartu
Jurjewa: Schnakenburga	Tartu
Jurjewi linan	Tartu
Jurjewi'n (Tartun)	Tartu
Jurjewin-Tartun	Tartu
Jurjewis (Tartus)	Tartu
Jurjewis-Tartus	Tartu
Jurjewâ	Tartu
Jurjewâ (Tehrbatâ	Tartu
Jurjewâ (Tehrbatâ)	Tartu
Tarto liinan	Tartu
Jurjewis - Tartus	Tartu
Tartu	Tartu
Tartu etc.	Tartu
Tartu linnas	Tartu
Tartu?	Tartu
Tartus	Tartu
Tartun	Tartu
[Dorpat]?	Tartu
in Jurjew (Dorpat	Tartu
Дерптъ	Tartu
Тарту (Юрьев)	Tartu
Юрьев	Tartu
Юрьев?	Tartu
Юрьев (Dorpat	Tartu
Юрьев (Tartu)	Tartu
Юрьев (Дерпт)	Tartu
Юрьев (б. Дерпт)	Tartu
Юрьев : б.и	Tartu
Юрьев :s.n	Tartu
Юрьев-Tartu	Tartu
Юрьев-Дерпт	Tartu
Юрьев-Тарту	Tartu
Tartu (Dorpat)	Tartu
Tartu - Dorpat	Tartu
Tartu / Ihaste	Tartu
Tartu [i.e. Torino]	Tartu
Tartu [jne.	Tartu
Tartu [jne.]	Tartu
Tartu(Dorpat)	Tartu
Tartu-Dorpat	Tartu
Tartu/Dorpat	Tartu
Tartumaa	Tartu
Tartus (Dorpat)	Tartu
Taрту	Tartu
Tērbata	Tartu
Veetka - Tartu	Tartu
Youriev (Tartu)	Tartu
В Дерпте	Tartu
Дерпт	Tartu
Дерпт?	Tartu
ТАрту	Tartu
Тарту	Tartu
Тарту?	Tartu
Тарту (Эстония)	Tartu
Тарту :(B	Tartu
Тарту [Эстонский научно-исследовательский институт животноводства и ветеринарии]	Tartu
Tartu linn	Tartu linn
Tartus :[s.n.]	Tartus :[s.n.]
Taru	Taru
Mustla (Viljandimaa)	Tarvastu
Mustla [Viljandimaa]	Tarvastu
Mustla alevik	Tarvastu
Tarvastu	Tarvastu
Tarvastu?	Tarvastu
Tarvastu [Viljandimaa]	Tarvastu
Tarvastun [Viljandimaa]	Tarvastu
Taskent	Tashkent
Ташкент	Tashkent
Тошкент	Tashkent
Taunusstein	Taunusstein
Tai	Taï
Tbilisi	Tbilisi
Thbilisi	Tbilisi
Тифлис	Tbilisi
Тбилиси	Tbilisi
Te Haarlem	Te Haarlem
Tehvandi (Valgamaa)	Tehvandi (Valgamaa)
Tel Aviv	Tel Aviv
Тель-Авив	Tel Aviv
TEA	Tela
Tempa	Tempa (Hiiumaa)
Tempa (Hiiumaa)	Tempa (Hiiumaa)
Tepelvälja	Tepelvälja
Terpata	Terpatâ
Terpatâ	Terpatâ
Thanh-Long	Thanh-Long
's-Gravenhage	The Hague
Den Haag	The Hague
Hague	The Hague
Haag	The Hague
The Hague	The Hague
The Hague [etc.]	The Hague
The Hague etc.	The Hague
The Hague?	The Hague
The Oaks, N.S.W	The Oaks, N.S.W
Thessaloniki	Thessaloníki
Thirlmere	Thirlmere
Thirlmere (Austraalia)	Thirlmere
Thun	Thun
Thunder Bay (Ont.)	Thunder Bay (Ont.)
Tiduvere küla	Tiduvere küla
Tierp	Tierp
Kasepää	Tiheda
Tiheda	Tiheda
Tihemetsa	Tihemetsa
Tihemetsa, Pärnumaa	Tihemetsa
Voltveti	Tihemetsa
[Tihemetsa], Pärnumaa	Tihemetsa
Tiirimetsa	Tiirimetsa
Tiirimetsa [Saaremaa]	Tiirimetsa
Tiitsa	Tiitsa
Tiitsa (Võrumaa)	Tiitsa
Kõrveküla (Tartumaa)	Tila küla
Tila (Tartumaa)	Tila küla
Tila küla	Tila küla
Tilga	Tilga
Tilga küla	Tilga küla
Tilgu	Tilgu
Temesvar	Timişoara
Tindi (Võrumaa)	Tindi (Võrumaa)
Tiranë	Tirana
Harku	Tiskre
Харку	Tiskre
Tiskre	Tiskre
Tiskre küla	Tiskre
Тобольск	Tobolsk
Tobolsk [i.e. Nordhausen]	Tobolsk [i.e. Nordhausen]
Todmorden	Todmorden
Tohkri (Võru maakond)	Tohkri (Võru maakond)
Tohkri (Võrumaa)	Tohkri (Võru maakond)
Toijala	Toijala
Toila	Toila
Toila (Ida-Virumaa)	Toila
Toila [Ida-Virumaa	Toila
Toila [Ida-Virumaa]	Toila
Tokio	Tokyo
Tokyo	Tokyo
Tōkyō	Tokyo
Toledo	Toledo
Tollarp	Tollarp
Tolworth, Surrey	Tolworth, Surrey
Tomsk	Tomsk
Томск	Tomsk
Tondi	Tondi
Tondi [Tallinn	Tondi [Tallinn
Tondi [Tallinn]	Tondi [Tallinn
Tooma	Tooma
Tooma [Jõgevamaa]	Tooma [Jõgevamaa]
Tootsi	Tootsi
Tootsi (Pärnumaa)	Tootsi
Tori	Tori
Торгель	Tori
Torma	Torma
Toronto	Toronto
Toronto [etc.]	Toronto
Toronto?	Toronto
Torontos	Toronto
Toronto (Ont.)	Toronto (Ont.)
Toronto (Ontario)	Toronto (Ont.)
Toronto, Canada	Toronto (Ont.)
Toronto, Ont	Toronto (Ont.)
Torrance, Calif	Torrance, Calif
Torrazza Piemonte	Torrazza Piemonte
Torredonjimeno	Torredonjimeno
Torshälla	Torshälla
Thorn	Toruń
Torun	Toruń
Toruń	Toruń
Toruń	Toruń
Totnes	Totnes
Tournai	Tournai
Toyoake, Japan	Toyoake, Japan
Tōkyō	Tōkyō
Treimani	Treimani
Trelleborg	Trelleborg
Trexlertown (Pa.)	Trexlertown (Pa.)
Trier	Trier
Tristfer	Tristfer
Tromsø	Tromsø
Trondheim	Trondheim
Troyes	Troyes
Tsarskoje-Selo	Tsarskoje-Selo
Ленинград-Пушкин	Tsarskoje-Selo
Пушкин	Tsarskoje-Selo
Tsiistre (Võrumaa)	Tsiistre (Võrumaa)
Tsirguliina	Tsirguliina [Valgamaa]
Tsirguliina (Valgamaa)	Tsirguliina [Valgamaa]
Tsirguliina [Valgamaa]	Tsirguliina [Valgamaa]
Tsitre [Harjumaa]	Tsitre [Harjumaa]
Цхинвали	Ts’khinvali
Tubala	Tubala
Tucson, Ariz	Tucson, Ariz
Tudulinna	Tudulinna
Tudulinna (Ida-Virumaa)	Tudulinna
Tuhala	Tuhala
Tuhalaane	Tuhalaane
Тула	Tula
Tumba	Tumba
Tupenurme	Tupenurme
Tupenurme (Saare maakond)	Tupenurme (Saare maakond)
Tupenurme (Saaremaa)	Tupenurme (Saare maakond)
Tupenurme [Saaremaa]	Tupenurme (Saare maakond)
Turba	Turba
Turbaneeme [Harjumaa	Turbuneeme
Turbuneeme	Turbuneeme
Turenki	Turenki
Torino	Turin
Abo	Turku
Turku	Turku
Turku [etc.]	Turku
Turku?	Turku
Turu	Turku
Åbo	Turku
Åbo?	Turku
Turnhout	Turnhout
Tuudi	Tuudi
Tuula	Tuula
Tuula (Harjumaa)	Tuula (Harjumaa)
Tuula küla	Tuula (Harjumaa)
Tvedestrand	Tvedestrand
Калинин	Tver
Тверь	Tver
Tyresö [Rootsi]	Tyresö [Rootsi]
Тюмень	Tyumen
Täby	Täby
Tähtvere	Tähtvere
Täkumetsa	Täkumetsa
Tänassilma	Tänassilma
Tännassilma	Tännassilma
Tääksi	Tääksi (Viljandimaa)
Tääksi (Viljandimaa)	Tääksi (Viljandimaa)
Tórshavn	Tórshavn
Tõdva	Tõdva
Tõdva küla	Tõdva küla
Tõhela	Tõhela
Tõlluste	Tõlluste
Tõmmiku	Tõmmiku
Tõnura	Tõnura
Meeri	Tõravere
Tõravere	Tõravere
Тыравере	Tõravere
Tõrva	Tõrva
Tõrva?	Tõrva
Tõrvas	Tõrva
Tõrwa	Tõrva
Tõrwas	Tõrva
Терва	Tõrva
Tõrvandi	Tõrvandi
Tõrvandi (Tartumaa)	Tõrvandi
Tõrvandi alevik	Tõrvandi
Tõstamaa	Tõstamaa
Тестама	Tõstamaa
Tõstamaa (Pärnumaa)	Tõstamaa
Tõstamaa [Pärnumaa]	Tõstamaa
Tõutsi	Tõutsi
Tübingen	Tübingen
Türi-Alliku	Türi-Alliku
Türil	Türil
Türisalu	Türisalu
Türju	Türju
Türju (Saaremaa)	Türju (Saaremaa)
Tšerbakul	Tšerbakul
Uddevalla	Uddevalla
Udine	Udine
Udriku	Udriku
Uduvere/Meiuste, Saaremaa	Uduvere/Meiuste, Saaremaa
Уфа	Ufa
Ugandi	Ugandi
Uhtna [Lääne-Virumaa]	Uhtna [Lääne-Virumaa]
Улаан-баатар	Ulan Bator
Улаанбаатар	Ulan Bator
Улан-баатар	Ulan Bator
Улан-Удэ	Ulan-Ude
Ulila [Tartumaa]	Ulila [Tartumaa]
Ulm	Ulm
Ulm [Deutschland]	Ulm
Ulvi	Ulvi
Uljanovsk	Ulyanovsk
Ульяновск	Ulyanovsk
Umbusi (Jõgevamaa)	Umbusi (Jõgevamaa)
Umbusi [Jõgevamaa	Umbusi (Jõgevamaa)
Umbusi küla	Umbusi (Jõgevamaa)
Umea	Umeå
Umea [Rootsi]	Umeå
Umeå	Umeå
Ungari	Ungari
Ubsaliae	Uppsala
Uppsala	Uppsala
Uppsalas	Uppsala
Upsala	Uppsala
Upsaliae	Uppsala
Urbana (Illinois)	Urbana (Illinois)
Urbana [etc.	Urbana (Illinois)
Urumarja	Urumarja
Urvaste	Urvaste
Urvastes	Urvaste
Urvaste (Võrumaa)	Urvaste [Võrumaa]
Urvaste [Võrumaa]	Urvaste [Võrumaa]
Urvaste küla	Urvaste küla
Usquert [Holland]	Usquert [Holland]
Utrecht	Utrecht
Uudeküla	Uudeküla
Uue-Kariste	Uue-Kariste
Uue-Saaluse	Uue-Saaluse
Uue-Võidu	Uue-Võidu
Uuemõisa	Uuemõisa
Uuemõisa (Saaremaa)	Uuemõisa (Saaremaa)
Uuemõisa [Läänemaa]	Uuemõisa [Läänemaa]
Uuesalu	Uuesalu
Uulus [Pärnumaa	Uulus [Pärnumaa
Uuri	Uuri
Uuri küla (Harjumaa)	Uuri küla (Harjumaa)
Uusikaupunki	Uusikaupunki
Uusvada	Uusvada
Ungvár	Uzsgorod
Uzsgorod	Uzsgorod
Ужгород	Uzsgorod
V Praze	V Praze
Vaasa	Vaasa
Vasa	Vaasa
Vadstena	Vadstena
Vadstena (Rootsi)	Vadstena
Wadstena	Vadstena
Vaeküla	Vaeküla
Vaela	Vaela
Vaela [Harjumaa]	Vaela
Vahastu	Vahastu
Vahi	Vahi
Vahi (Tartumaa)	Vahi (Tartumaa)
Vahi küla	Vahi küla
Vaiatu	Vaiatu
Vaiatu küla	Vaiatu
Vaida	Vaida
Vaida-Aruvalla	Vaida
Vaimastvere	Vaimastvere
Vaimastvere (Jõgevamaa)	Vaimastvere (Jõgevamaa)
Vaimõisa	Vaimõisa
Vaivara	Vaivara
Vaivere (Saaremaa)	Vaivere (Saaremaa)
Vajangu	Vajangu
Valencia	Valencia
València	Valencia
Valga	Valga
Valgas	Valga
Valka [s.o. Valga]	Valga
Walk [s.o. Valga	Valga
Walk [s.o. Valga]	Valga
Валк	Valga
Valk	Valga
Valka	Valga
Walga	Valga
Walgas	Valga
Walk	Valga
Валга	Valga
Валка	Valga
Valgamaa	Valgamaa
Valgamaal	Valgamaal
Valgjärve	Valgjärve
Valgjärve (Põlvamaa)	Valgjärve (Põlvamaa)
Valgjärve [(Põlvamaa)	Valgjärve (Põlvamaa)
Valgjärve [Põlvamaa]	Valgjärve (Põlvamaa)
Valgjärvel [Põlvamaa]	Valgjärve (Põlvamaa)
Valgma	Valgma
Valgu	Valgu
Valgu [Raplamaa]	Valgu [Raplamaa]
Valguta	Valguta
Valguta küla	Valguta
Valjala	Valjala
Valkla	Valkla
Valkla (Harjumaa)	Valkla
Valkse	Valkse
Valladolid	Valladolid
Valma	Valma
Valmiera	Valmiera
Вольмар	Valmiera
Valtu	Valtu
Vammala	Vammala
Van Nuys (Cal.)	Van Nuys (Cal.)
Vana	Vana
Vana-Antsla	Vana-Antsla
Vana-Antsla [Võrumaa]	Vana-Antsla
Vana-Järve	Vana-Järve
Vana-Kariste	Vana-Kariste
Vana-Saaluse (Võrumaa)	Vana-Saaluse (Võrumaa)
Vana-Vigala	Vana-Vigala
Vana-Võidu	Vana-Võidu
Vanaküla	Vanaküla
Vanamõisa	Vanamõisa
Vanamõisa, Saue vald	Vanamõisa, Saue vald
Vancouver	Vancouver
Vancouver?	Vancouver
Vancouver (B.C.)	Vancouver
Vancouver [Kanada]	Vancouver
Vancouver, B.C	Vancouver
Vandjala (Harjumaa)	Vandjala (Harjumaa)
Võerdla	Vandjala (Harjumaa)
Vanha-Ulvila	Vanha-Ulvila
Vannes	Vannes
Vantaa	Vantaa
Vara	Vara (Tartumaa)
Vara (Tartumaa)	Vara (Tartumaa)
Varbla	Varbla
Warblas	Varbla
Varbla (Pärnumaa)	Varbla
Varbola	Varbola
Varbuse	Varbuse
Варбузе	Varbuse
Варбусе	Varbuse
Vardja	Vardja
Varese	Varese
Варна	Varna
Varnja	Varnja
Varnja küla [Tartumaa]	Varnja
Varstu	Varstu
Varstu (Võrumaa)	Varstu
Vasalemma	Vasalemma
Vasalemmas	Vasalemma
Vasalemma (Harjumaa)	Vasalemma
Vasta küla	Vasta küla
Vastemõisa	Vastemõisa
Vastse-Kuuste	Vastse-Kuuste
Vastse-Kuuste (Põlvamaa)	Vastse-Kuuste
Vastse-Otepää	Vastse-Otepää
Vastseliina	Vastseliina
Vastseliinas	Vastseliina
Vastseliina [Võrumaa]	Vastseliina
Vasula	Vasula (Tartumaa)
Vasula (Tartumaa)	Vasula (Tartumaa)
Vatla	Vatla
Veetka	Veetka
Vehendi	Vehendi
Veibri	Veibri
Vejbystrand	Vejbystrand
Vejle	Vejle
Новгород	Velikiy Novgorod
Великие Луки	Velikiye Luki
Велико-Търново	Veliko Tŭrnovo
Велико Търново	Veliko Tŭrnovo
Velise	Velise
Velise (Raplamaa)	Velise
Velise [Raplamaa	Velise
Veltsa	Veltsa
Veltsa?	Veltsa
Veneküla (Harjumaa)	Veneküla (Harjumaa)
Venemaa	Venemaa
Venemaa?	Venemaa
Россия	Venemaa
Venevere	Venevere
Venevere [Lääne-Virumaa]	Venevere
Vergi	Vergi
Veriora	Veriora
Veriora [Põlvamaa]	Veriora
Verona	Verona
Veskimäe	Veskimäe
Veszprem	Veszprém
Vetepere (Järvamaa)	Vetepere (Järvamaa)
Vetepere [Järvamaa]	Vetepere (Järvamaa)
Vetepere küla (Albu vald)	Vetepere (Järvamaa)
Vetlanda	Vetlanda
Vicenza	Vicenza
Victoria (B.C.)	Victoria (B.C.)
Victoria [Australia]	Victoria [Australia]
Vidrike	Vidrike
Vidrike (Valgamaa)	Vidrike
Vidrike küla	Vidrike
Vidruka	Vidruka
Vienna	Vienna
Vienna [etc.]	Vienna
Viin	Vienna
Wien	Vienna
Wien [etc.]	Vienna
in Wien	Vienna
Vienna, VA, USA	Vienna, VA, USA
Vigala	Vigala
Vigalas	Vigala
Vigala [Raplamaa]	Vigala [Raplamaa]
Vigala vald	Vigala [Raplamaa]
Vihasoo	Vihasoo
Vihula	Vihula
Viidumäe	Viidumäe
Viidumäe (Saaremaa)	Viidumäe
Viimsi	Viimsi
Viimsi (Harjumaa)	Viimsi
Viimsi (harjumaa)	Viimsi
Viimsi [Harjumaa	Viimsi
Viimsi [Harjumaa]	Viimsi
Viimsi vald	Viimsi vald
Viinistu	Viinistu
Viinistu [Harjumaa]	Viinistu [Harjumaa]
Viira	Viira
Viira (Tartumaa)	Viira (Tartumaa)
Viiratsi	Viiratsi
Viisu	Viisu
Viitasaari	Viitasaari
Viitka	Viitka
Viitna	Viitna
Viitna (Lääne-Virumaa)	Viitna
Vijayawada	Vijayawada
Vilina küla [Jõgevamaa]	Vilina küla [Jõgevamaa]
Vilivere	Vilivere
Fellin	Viljandi
Vijandi	Viljandi
Viljandi	Viljandi
Viljandi?	Viljandi
Viljandis	Viljandi
Wiljandi	Viljandi
Wiljandis	Viljandi
Вильянди	Viljandi
Вилянди	Viljandi
Феллин	Viljandi
Koordi [Viljandimaa	Viljandimaa
Viljandimaa	Viljandimaa
Villevere	Villevere
Giedraičiai - Vilnius	Vilnius
Vilnius	Vilnius
Vilniuys	Vilnius
Vilno	Vilnius
Wilna	Vilnius
Wilno	Vilnius
Вильна	Vilnius
Вильнюс	Vilnius
вильнюс	Vilnius
Vilusi [Ida-Virumaa]	Vilusi [Ida-Virumaa]
Ида-Вирумаа	Vilusi [Ida-Virumaa]
Vilustõ [Põlvamaa]	Vilustõ [Põlvamaa]
Vimmerby	Vimmerby
Vinni	Vinni
Vinni (Lääne-Virumaa)	Vinni (Lääne-Virumaa)
Vinni [Lääne-Virumaa]	Vinni (Lääne-Virumaa)
Virtsu	Virtsu
Viru-Jaagupi [Lääne-Virumaa]	Viru-Jaagupi [Lääne-Virumaa]
Viru-Nigula	Viru-Nigula
Virumaa	Virumaa
Viruna (Pärnumaa)	Viruna (Pärnumaa)
Virve (Harjumaa)	Virve küla
Virve küla	Virve küla
Висагинас	Visaginas
Visby	Visby
Visela	Visela
Витебск	Vitebsk
Viterbo	Viterbo
Vitsiku küla	Vitsiku küla
Vittorio Veneto	Vittorio Veneto
Viljani	Viļāni
Владимир	Vladimir
Vladivostok	Vladivostok
Владивосток	Vladivostok
Vodja	Vodja
Eesti [Voka (Ida-Virumaa)]	Voka
Eesti, [Voka, Ida-Virumaa]	Voka
Pühajõe	Voka
Voka	Voka
Voka [Ida-Virumaa]	Voka
Волгоград	Volgograd
Вологда	Vologda
Voore [Jõgevamaa]	Voore [Jõgevamaa]
Ormsö	Vormsi
Vormsi	Vormsi
Воронеж	Voronezh
Vratislavi	Vratislavi
Viborg	Vyborg
Viiburi	Vyborg
Viipuri	Vyborg
Wiborg	Vyborg
Vädra	Vädra
Väike-Maarja	Väike-Maarja
Väike-Maarjas	Väike-Maarja
Väike-Pungerja (Ida-Virumaa)	Väike-Pungerja (Ida-Virumaa)
Väimela	Väimela
Väimela [Võrumaa]	Väimela
Väljaküla	Väljaküla
Väljataguse küla	Väljataguse küla
Vällingby	Vällingby
Вяллингби	Vällingby
Vändra	Vändra
Vändras	Vändra
Феннерн	Vändra
Vändra [Pärnumaa]	Vändra
Вана-Вяндра	Vändra
Vändra-Kurgja	Vändra-Kurgja
Värati [Pärnumaa]	Värati [Pärnumaa]
Tallinn-Värska	Värska
Tartu-Värska	Värska
Verska	Värska
Värska	Värska
Вярска	Värska
Värska (Põlvamaa)	Värska (Põlvamaa)
Väsby	Väsby
Västervik	Västervik
Västervik [Rootsi]	Västervik
Västerås	Västerås
Västerås?	Västerås
Växjö	Växjö
Vääna-Jõesuu	Vääna-Jõesuu
Vääna-Ohtu (Harjumaa)	Vääna-Jõesuu
Väänla	Väänla (Läänemaa)
Väänla (Läänemaa)	Väänla (Läänemaa)
Väätsa	Väätsa
Väätsa (Järvamaa)	Väätsa
Väätsa [Järvamaa]	Väätsa
Vårby	Vårby
Sääritsa [Jõgevamaa]	Võduvere
Võduvere	Võduvere
Võduvere [Lääne-Virumaa]	Võduvere [Lääne-Virumaa]
Võhma	Võhma-Kabala (Viljandimaa)
Võhmas	Võhma-Kabala (Viljandimaa)
Võhma-Kabala (Viljandimaa)	Võhma-Kabala (Viljandimaa)
Võisiku	Võisiku
Võivaku (Viljandimaa)	Võivaku (Viljandimaa)
Võlla	Võlla
Võnnu	Võnnu
Võnnu (Tartumaa)	Võnnu [Tartumaa]
Võnnu [Tartumaa]	Võnnu [Tartumaa]
Võntküla	Võntküla
Verro	Võru
Viru	Võru
Võro	Võru
Võrol	Võru
Võru	Võru
Võru?	Võru
Võrus	Võru
Wõru	Võru
Wõrus	Võru
Võrumaa	Võru
Werro	Võru
Верро	Võru
Выру	Võru
Кюндя (Võrumaa)	Võru
Võsivere	Võsivere
Võsu	Võsu
Võsupere	Võsu
Võsupere (Lääne-Virumaa)	Võsu
Võsupere küla	Võsu
Võtikvere (Jõgevamaa)	Võtikvere (Jõgevamaa)
Võtikvere [Jõgevamaa]	Võtikvere (Jõgevamaa)
W Warszawie	W Warszawie
Waddil	Waddil
Wagga Wagga (N.S.W.)	Wagga Wagga (N.S.W.)
Wainuiomata	Wainuiomata
Walden, New York	Walden, New York
Walkā	Walkā
Vol	Wall
Rieden	Wallisellen / Rieden
Warkworth	Warkworth
Warkworth (Ontario)	Warkworth (Ontario)
Varsovie	Warsaw
Varssav	Warsaw
Varssavi	Warsaw
Warsaw	Warsaw
Warschau	Warsaw
Warszawa	Warsaw
Варшава	Warsaw
Washington	Washington
Washington (D.C.) : Department of State, Bureau of Oceans and International Environmental and Scientific Affairs	Washington
Washington (D.C.)	Washington, D.C
Washington (DC)	Washington, D.C
Washington, D. C	Washington, D.C
Washington, D.C	Washington, D.C
Washington, D.C.	Washington, D.C
Washington, DC	Washington, D.C
Waterloo (Ont.)	Waterloo (Ont.)
Waterloo, Ont	Waterloo (Ont.)
Waterlow	Waterlow
Watford	Watford
Watford (Herts)	Watford
Wedemark [Deutschland]	Wedemark [Deutschland]
Weihenstephan	Weihenstephan
Weimar	Weimar
Веймар	Weimar
Weinheim	Weinheim
Weinsberg	Weinsberg
Weissenhorn [Deutschland]	Weissenhorn [Deutschland]
Weissenhorn	Weißenhorn
Wellington	Wellington
Welwyn Garden City	Welwyn Garden City
Wemding	Wemding
Wenden	Wenden
Werdau	Werdau
Wesel	Wesel
West Vancouver	West Vancouver
West Vancouver (B.C.)	West Vancouver (B.C.)
Westford	Westford
Westport, Conn	Westport, Conn
Wetherill Park (Australia)	Wetherill Park (Australia)
Wetteren?	Wetteren
Wheaton, IL	Wheaton, IL
Wiesbaden	Wiesbaden
Wiesbaden [etc.]	Wiesbaden
Wiesbaden?	Wiesbaden
Willimantic	Willimantic (Conn.)
Willimantic (Conn.)	Willimantic (Conn.)
Willowdale [Kanada]	Willowdale [Kanada]
Wilmington	Wilmington
Wilmington (Del.)	Wilmington (Del.)
Winchester (Mass.)	Winchester (Mass.)
Windsor	Windsor
Winnipeg	Winnipeg
Winnipeg (Manitoba)	Winnipeg (Manitoba)
Winterthur [Switzerland]	Winterthur [Switzerland]
Wismar	Wismar
Wittebergae	Wittebergae
Wittemberch [Wittenberg]	Wittemberch [Wittenberg]
Vitembergae	Wittenberg Lutherstadt
Wittenberg	Wittenberg Lutherstadt
Wittenberg Lutherstadt	Wittenberg Lutherstadt
Wittenbergæ	Wittenbergæ
Woking	Woking
Wolfenbüttel	Wolfenbüttel
Woodsville	Woodsville
Woodsville (N.H.)	Woodsville (N.H.)
Worcester	Worcester
Worms	Worms
Wołowiec	Wołowiec
Breslau	Wrocław
Wroclaw	Wrocław
Wrocław	Wrocław
Wrocław-Wojnowice	Wrocław-Wojnowice
Wästerås	Wästerås
Würzburg	Würzburg
Jaroslavl	Yaroslavl
Ярославль	Yaroslavl
Yarraville (Vic.)	Yarraville (Vic.)
Екатеринбург	Yekaterinburg
Свердловск	Yekaterinburg
Jerevan	Yerevan
Yerevan	Yerevan
Ереван	Yerevan
Երևան	Yerevan
Евпатория	Yevpatoriya
Heshan	Yiyang
Yonkers (N.Y.)	Yonkers (N.Y.)
Йошкар-Ола	Yoshkar-Ola
Ystad	Ystad
Zabrze	Zabrze
Zagreb	Zagreb
Zaltbommel	Zaltbommel
Zamość	Zamość
Zaragoza	Zaragoza
Зарайск	Zaraysk
Berlin-Zehlendorf	Zehlendorf
Zeulenroda	Zeulenroda
Житомир	Zhytomyr
Zlín	Zlín
Zoetermeer	Zoetermeer
Zollikon	Zollikon
Zollikon bei Zürich	Zollikon
Zug	Zug
Zwickau	Zwickau
Zuric	Zürich
Zürich	Zürich
Zürich [etc.]	Zürich
[Burbank] (California)	[Burbank] (California)
[Grēnes] Latvia	[Grēnes] Latvia
[Kareda] Järvamaa	[Kareda] Järvamaa
[Kundli], India	[Kundli], India
[Porsa] Mulgimaa	[Porsa] Mulgimaa
Viborg	[Viborg], Taani
[Viborg], Taani	[Viborg], Taani
Äetsä	Äetsä
Ähijärve	Ähijärve
Ähijärve [Võrumaa]	Ähijärve [Võrumaa]
Äksi	Äksi (Harjumaa)
Äksi (Harjumaa)	Äksi (Harjumaa)
Älvsjö	Älvsjö
Ämari	Ämari
Ämmuste	Ämmuste
Ämmuste [Viljandimaa]	Ämmuste [Viljandimaa]
Ängelholm	Ängelholm
Änniksaare	Änniksaare
Änniksaare (Ida-Virumaa)	Änniksaare (Ida-Virumaa)
Ääsmäe	Ääsmäe
Ääsmäe (Harjumaa)	Ääsmäe
Åhus	Åhus
Åland	Åland
Aarhus	Århus
Aarhus [etc.]	Århus
Århus	Århus
Õssu	Õssu
Õssu küla	Õssu
Õvi	Õvi
Õvi (Tartumaa)	Õvi (Tartumaa)
Öjersjö	Öjersjö
Ömmern	Ömmern
Orebro	Örebro
Örebro	Örebro
Örebro - Rootsi	Örebro
Örebro [Rootsi]	Örebro
Örnsköldsvik [Rootsi]	Örnsköldsvik [Rootsi]
Üdruma	Üdruma
Ühtri (Hiiumaa)	Ühtri (Hiiumaa)
Ühtri [Hiiumaa]	Ühtri (Hiiumaa)
Ülenurme	Ülenurme
Ülenurme (Tartumaa)	Ülenurme
Ülenurme [Tartumaa]	Ülenurme
Ülenurme, Kambja vald	Ülenurme
Český Krumlov	Český Krumlov
Ķekava	Ķekava
Hiina	Ķīna
Hiinas	Ķīna
Ķīna	Ķīna
Łódź	Łódź
Chile	Şile
Šotimaa	Šotimaa
Šveits	Šveits
Кавасту	Кавасту
Остров	Остров
24 lk	
8 lk	
?	
Abo, 1973	
S. l	
S. l.	
S. l. : s. n	
S. l. : s.n	
S. l. :s.n	
S. l.] :[s.n.	
S.l	
S.l.	
s. l	
s.l	
s.l.	
©2007	
©2019	
©2020	
©2021	
©2022	
Б.м	
Б.м.	
(	
(  :	
( :	
(:	
(Belgia)	
(Dorpat	
(Hamburg	
(Köln	
(Leipzig	
(Lohkva	
(Lohkva (Tartumaa)	
(Läti)	
(Mitau	
(Narva	
(Oberpahlen	
(Põltsamaa	
(Riia	
(Schmalkalden	
(St.-Pétersbourg	
(Stockholm	
(Suurbritannia)	
(Tallinn	
(Tallinnas	
(Tartu	
(Tartu : Vanemuise mimeogr.)	
(Taškent)	
(Utrecht	
(Vahi (Tartu maakond)	
(Venemaa)	
(Viljandi	
(Võru	
([(Tallinn)]	
([Askim (Norra)]	
([Hongkong)]	
([Huhmari (Soome)]	
([Imavere (Järvamaa)]	
([Leck (Saksamaa)]	
([Lohkva (Tartu maakond)]	
([Lohkva (Tartumaa)]	
([Lohkva)]	
([Läti])Lbi ja värvi	
([Oberpahlen	
([Pärnamäe (Harjumaa)]	
([Tallinn	
([Tallinn)]	
([Tartu (Tartu maakond)]	
([Täkumetsa (Ida-Virumaa)]	
([Vahi (Tartu maakond)]	
([Vahi (Tartumaa)]	
([Viimsi (Harjumaa)]	
([Võsivere (Tartumaa)]	
([Wesenberg	
([Лохква (Tartumaa)]	
([Тякуметса (Ида-Вирумаа)]	
(Ревель	
(Рига	
(Таллин	
)Tallinn	
)Tartu	
*Таллин	
/[Austraalia]	
A. Mickwitz	
A. Tõllasepp	
Aare	
Achim	
Ajakirjade	
Ajanta Offset and Packagings Limited	
Alfter-Oedekoven	
Amritapuri	
Andaluusia	
Andaluusia (Hispaania	
Ann Arbor (Mich.	
Armagh, Ireland	
Arostryck	
Artprint	
Aug	
AÜE	
AÜEs	
AÜE [Araabia Ühendemiraadid]	
B-Ieper	
BasseDruck	
Bd	
Belarus	
Belgien	
Belmore	
Berlgia	
Berlin-Schöneberg	
Bialastok	
Białostock	
Binghamton, N. Y	
Boca Raton (Fla.) [etc.]	
Boden	
Bodenheim	
Bonn-Grunwald	
Booksfactory	
Borõs	
Bosnia ja Hertsegoviina	
Bosnia-Hertsegoviina	
Box Hill, Vic	
Brandenburg (Havel	
Brasiilia?	
Brooklyn, N. Y	
"Buchdruckerei ""Aug. Mickwitz"""	
Burnaby, B.C	
Bussum [Holland]	
Bydgoszczy	
C. Mattiesen	
CIMO	
Cardliff [etc.]	
Cecis	
Ch. Assafrey	
Champaign (Ill.) [etc.]	
Champain (Ill.) [etc.]	
Charlottenburg	
Chatham, Kent	
Chichester	
Chippenham (Great Britain	
Concord (New Hampshire	
Coxsackie	
Cмоленск	
DIYA USA Commercial Printing Company	
Dalholm	
Danmark	
Darmstadt-Arheilgen	
Das	
Diesdorf bei Gäbersdorf	
Dinglingen (Baden	
Dongguan [Hiina]	
Dongguan, Kiina	
Dorpat : J. Brendeken	
Dorpat :fC. Mattiesen	
Dresden-Freital	
Dromore, Ühendkuningriik, Põhja-Iirimaa	
EMMTUI	
Edinburgh and London	
Edsbruck	
Edsbruk	
Eislebenis	
Ekenäs [Finland]	
Elera	
Erfurt (SDV	
Erfurt(SDV	
Espagne	
Estländische Druckerei A.-G.	
European Union	
ЕС	
Faatum	
Farigliano	
Foster City, CA	
France	
Frankfurt (Main	
Frankfurt (Oder	
Frankfurt Maini ääres	
Freising-München	
Gauvin Press	
Gedani	
Gedruckt bei J. P. Sollinger	
General W.M. Black	
Gotoburgi	
Gourdienne	
Grand Haven	
Greater Noida	
Greif	
Grätz	
Guangdong	
Guangdong, Hiina	
Gylling	
Gütersloh [Saksamaa]	
H. Heidemanni nim. trükikoda	
H. Heidemanni nimeline trükikoda	
H. Laakmann	
Haapasalu	
Haasbek	
Hackensack (N.J.) [etc.]	
Halle (Saale	
Halle a. d. S	
Hampstead Gardens	
Hapвa	
Hartwell, Vic	
Hawthorn	
Hawthorn [etc.]	
Heideheim (Brenz	
Heidenheim/Brenz	
Heidnheim/Brenz	
Helsingissa	
Helsiniki	
Helsinki :fK. F. Puromiehen Kirjapaino	
Helsinkki	
Hildburghausen	
Hollandi	
Hong-Kong	
HongKong	
Horvaatia	
Huhmari (Soome	
Hyvinkää [Soome]	
Hägersten	
I.k.	
IV	
Iceland	
Igaunijā	
Iirimaa	
Iisrael	
Imavere (Järvamaa	
Indoneesia	
Iourieff	
Israel	
Italia	
Italien	
J. Klinkhardt	
Jahrgang	
Jelgawâ	
Jg	
Joensuu (Soome	
Jourrieff (Dorpat	
Jujrev	
Järjehoidja	
Jõhv	
K. Mattiesen	
Kaloprint Nyomda	
Katrinholm	
Keuruu [Soome]	
Kiliae	
Kiloni	
Kirchhain N.-L	
Kommunist	
Koolibri	
Kooperatiiv	
Korea	
Корнталь	
Krakovā	
Kreeka	
Kristanstad	
Kunst	
Kupar	
Kursaare	
Kõllered	
LXVII	
LaVergne (Tenn.	
Laevandus	
Lagny-sur-Marne	
Lahr/Schwardzwald	
Langley, B.C	
Lanham (Md.) [etc.]	
Lavergne, TN	
Leck (Saksamaa	
Leck [Saksamaa]	
Leck, Saksamaa	
Leedu [Klaipeda]	
Leiptsig	
Leipzig (SDV	
Lettland	
Leuven (Belgique	
Limbaschos	
Litauen	
Lithuania	
Lohkna	
Lohkva (Tartumaa	
Lohkva (Tartumaa)	
Lohkva [Tartumaa]	
Lohkva, Luunja vald	
Lohkva, Tartumaa	
Loima	
Loodus	
Louvain  (Belgique	
Louvain (Belgique	
Lunenburg, Vermont	
Лужицы	
Luton, Beds	
Luunja vald	
Luxemgourg	
Lät	
Läti, Jelgava	
Lódz	
Lõuna-Korea	
Lönnberg Print	
Порт-Артур	
Macomb, Ill	
Malaysia	
Martin (Tšehhoslovakkia SV	
Maryborough, Victoria	
Maryland	
Melle i. Hann	
Menu	
Mew York	
Michigan	
Middletown, [Delaware]	
Mikolowo	
Mississauga (Ontario	
Mississauga, Ontario	
Monte da Caparica	
Mulgimaa	
Mänttä	
Mänttä : Mäntän Kirjapaino	
München :fJ. G. Weiss'sche Buchdruckerei	
NSV Liit	
Nacka	
Nanjing, Hiina	
Narva : M. Minis	
Nats. K. Mattiesen	
Naumburg (Saale	
Netherland	
Neu-Ruppin	
New	
New York : Esto Printing Service	
Нижный Архыз	
Noor	
Norge	
Norway	
Nr	
Nõmme-Rahumäe	
Olion	
Orto	
Otava Book Printing	
Padstow, Cornwall	
Pantheum	
Paulton	
Paxton, Illinois	
Pb	
Peces	
Peeterburi	
Penang (Malaisia	
Penang [Malaisia]	
Perioodika	
Pernaviae	
Petropoli	
Petropoli [etc.]	
Pieksamäki	
Polijā	
Polonia	
Postimees	
Potsdam-Babelsberg	
Praque	
Príbram	
Punkaharju	
Pänu	
Pärnu :Pärnutrükk	
Pössneck	
Rahvaleht	
Rakver	
Rehwelé	
Rieden/Allgäu	
Ristna	
Riverwood (N.S.W.)?	
Riyadh (Saudi Araabia	
Rohrer	
Rumeenia	
Rumeenias	
Rothenburg O/L	
Ruudolstattis	
Rîgâ	
Rīgõ	
Ilmumiskoht teadmata	
Saksa Demokraatlik Vabariik	
Salo [Soome]	
Sangaste vald	
Sankt	
Santa Ana (Cal.	
Santa Ana, California	
Sarasota, Florida	
Sastamala	
Saudi Araabia	
Schl.-Ostrau	
Schlieren [Switzerland]	
Schlock	
Schnakenburg	
Schneverdingen [Deutschland]	
Schongau/Oberbayern	
Seabrook [USA]	
Seli	
Selja	
Selters (Taunus	
Selters (Taunus)	
Selters/Taunus	
Serbia	
Shaoguan [Hiina]	
Shenzhen, China	
Silakrogs	
Sindi (Pärnumaa	
Скарятино	
Slovakia	
Slovakkia	
Slovakkias	
Sloveenia	
Slovenia	
Slovenien	
Smedjebacken	
Solna	
In Spain	
Spausdino	
St	
St. Augustin	
St. Lucia	
St. Martin	
St. Michael	
St. Petersbrug	
St.Pétersbourg	
Stcokholm	
Stocholm	
Stockholm : I. Haggström	
Stockholm : Repro Print	
Strockholm	
Sundbyberg	
Suntero	
Suurbritania	
Sveits	
Swarzenbeck	
Switzerland	
Szobathely	
Södertalje	
Sünnimaa	
Süssen	
Süssen-Württ	
T(Tallinn	
T[allinn	
Tabasalu (Harjumaa	
Taimaa	
Taivan	
Tallahassee(Florida	
Tallinn : EKP Keskkomitee Kirjastuse trükikoda	
Tallinn : Lindforsi pärijad	
Tallinn : M. Martna	
Tallinn : Printon	
Tallinn : Tallinna Raamatutrükikoda	
Tallinn : Tallinna Tehnikaülikooli Kirjastuse trükikoda	
Tallinn : Tartu	
Tallinn : Tööstustrükk	
Tallinn : VÕT-i rotaprint	
Tallinn :fKommunist	
Tallinn :fOktoober	
Tallinn EKP Keskkomitee Kirjastuse trükikoda	
Tallinn Eestimaa sinodi trk.	
Tallinn J. H. Gressel	
Tallinn M. Schiffer ja M. Antje	
Tallinn Trükisilm	
Tallinn V. Ehrenpreis	
Tallinna Raamatutrükikoda	
Tallinni	
Tallinnn	
Tallinn}	
Talofka bei Ssaratow	
Tartu (Dorpat	
Tartu (Dorpt	
Tartu : Bärthelson	
Tartu : Tartu Trükikoda	
Tartu : Tartu Ülikooli Kirjastuse trükikoda	
Tartu : Vanemuise mimeogr.	
Tartu :fH. Heidemanni nimeline trükikoda	
Tartu H. Heidemanni nim. trükikoda	
Tartu K. A. Hermann	
Tartu Riiklik Ülikool	
Tartu Schnakenburg	
Tartu Ülikooli Kirjastuse trükikoda	
Tatrtu	
Teataja	
Tehrbat	
Tehrpata	
Tehrpatâ	
Trellborg	
Trento [Italy]	
Trieste (Itaalia	
Troppau (Ostsudetenland	
Trowbridge, Wilts	
Trånas	
Turnhout (Belgia	
Täkumetsa (Ida-Virumaa	
Täkumetsa [Ida-Virumaa	
Täkumetsa [Ida-Virumaa]	
Täkumetsa, Ida-Virumaa	
Tõravare	
Tšehhi	
Tšehhi Vabariik	
Tšehhoslovakkia	
Tарту	
"USA aurik ""General W.M. Black"" pardal"	
USA, Charleston	
Ukraina	
Украина	
Umbes	
United	
Uppsala : Arostryck	
Uus	
Uus ja täiendatud väljaanne	
Vaajakoski	
Vaba	
Vaba Maa	
Vah	
Vahi (Tartu maakond	
Vahi (Tartumaa	
Vahi [Tartumaa]	
Vahi, Tartumaa	
Vaimulik	
Vale Park (Austraalia	
Varrak	
Viborg, Taani	
Victoria	
Victoria [etc.]	
Vietnam	
Viro	
VÕT-i rotaprint	
Väike	
Välis	
Vänersborg	
Värnamo	
Västermalm	
Võsivere (Tartumaa	
Vаhi	
W. Volkmann	
Wallin	
Waterloo	
Weisenstein	
Wetteren (Belgium	
Willimantic, Conn	
Willingen-Schwenningen	
Wilmersdorf	
Wiltshire	
Wissenstein	
Wissmar	
Vitembergiae	
Wokingham [etc.]	
XXVIII	
Yad	
Yearbook	
Yugoslavia	
Zamoscii	
Zutphen [Netherlands]	
[(Hong Kong])	
[(Läti])	
[(Poola])	
[(Soome])	
[Flensburg], Saksamaa	
[Lohkva] (Tartumaa	
[Mikkeli,] Soome	
[Toronto] (Canada)	
[Turu], Soome	
[Vahi] (Tartumaa	
[Viborg,] Taani	
[Таллинн]	
]Lohkva	
]Tallinn	
a Paris	
e([Lohkva (Tartumaa)]	
e([Põltsamaa]	
fKommunist	
gedruckt in Leipzig	
gedruckt in der Druckerei des Oberbefehlshabers Ost	
i.k.	
in Altenburg	
in Berlin	
in Braunschweig	
in Dorpat	
in Erlangen	
in Fellin	
in Göttingen	
in Innsbruck	
in Metzingen	
in Mitau	
in Narva	
in Offenbach	
in Rudolstadt	
in Saarbrücken	
in Stuttgart	
in Tartu (Dorpat	
läti	
painettu EU:ssa	
s. n	
s.n	
stockholm	
tTartu	
tartu	
{Pärnu	
Äratrükk	
Åstrop	
Örebro (Rootsi	
Ühiselu	
à Tallinn	
Šanghai	
А. Миквиц	
А. Реннит	
А. Шнакенбург	
Берлин-Шарлоттенбург	
Вахи	
Вахи (Tartumaa	
Виймси	
Вильниус	
Вильно	
К.-Ярве	
Каэвур	
Кл	
Коммунист	
Кохтла Ярве	
Латвия	
Латия	
Линдфорс	
Литва	
Лохква	
Лохква (Tartumaa	
Лохква (Tartumaa)	
Москва : Красный пролетарий	
Октообер	
Отчет	
Прну	
Птроград	
Пунане тяхт	
Пяpну	
Пярны	
Ребиндер	
Реведь	
Ревел	
Ревелв	
Ревелъ	
Ростов-на Дону	
Ротапринт ТПИ	
Ротапринт ЦБТИ СНХ ЭССР	
С.-Петрбург	
Санкт	
Словакия	
Суурупи	
Тartu	
Тaрту	
ТАллин	
Таpа	
Тайнинское	
Таллин-Москва	
Таллини	
Таллинн :fЮхисэлу	
Таллинн(Ревель	
Таллиннн	
Таллнн	
Тарту :(	
Тарту :fтипография имени Х. Хейдеманна	
Тарту Коммунист	
Татрту	
Тип. Управления Делами СМ ЭССР	
Тип. им. Ханса Хейдеманна	
Типография Издательства ЦК КП Эстонии	
Типография Управления делами СМ ЭССР	
Тякуметса	
Тякуметса (Ida-Virumaa	
Тякуметса (Ида-Вирумаа	
Цикмä	
Ыйхви	
Эстляндская губернская тип.	
Юхисэлу	
в Ревеле	
таллин	
